grdan	ADJ;INDF;MASC;NOM;SG	grd|an
gubitak	N;ACC;SG	gubit|ak
guzica	N;NOM;SG	guz|ica
hladan	ADJ;INDF;MASC;NOM;SG	hlad|an
hladnoća	N;NOM;SG	hladn|oća
hlepčić	N;ACC;SG	hlep|čić
homoseksualnost	N;ACC;SG	homoseksualn|ost
hotelski	ADJ;MASC;VOC;SG	hotel|ski
hroničar	N;NOM;SG	hroni|čar
huliganski	ADJ;MASC;VOC;SG	huligan|ski
huliganstvo	N;ACC;SG	huligan|stvo
igračica	N;NOM;SG	igrač|ica
imenik	N;ACC;SG	ime|nik
imenjak	N;NOM;SG	ime|njak
instrumental	N;ACC;SG	instrument|al
ispiti	N;VOC;PL	i|s|piti
izdati	V.PTCP;PASS;PST;PL;MASC	i|z|dati
izgovor	N;ACC;SG	i|z|govor
izlet	N;ACC;SG	i|z|let
izmaknuti	V.PTCP;PASS;PST;PL;MASC	i|z|maknuti
iznenadan	ADJ;INDF;MASC;ACC;SG;INAN	i|z|nenadan
izrasti	V;IMP;2;SG	i|z|rasti
izravan	ADJ;INDF;MASC;NOM;SG	i|z|ravan
izračunati	V.PTCP;PASS;PST;PL;MASC	i|z|računati
izvesti	V;PRS;3;SG	i|z|vesti
izvrstan	ADJ;INDF;MASC;ACC;SG;INAN	i|z|vrstan
jamstvo	N;ACC;SG	jam|stvo
jedinica	N;NOM;SG	jedin|ica
jednodušan	ADJ;INDF;MASC;ACC;SG;INAN	jedn|o|dušan
jednoimen	ADJ;INDF;MASC;ACC;SG;INAN	jedn|o|imen
jednoženstvo	N;ACC;SG	jedn|o|ženstvo
jeftinoća	N;NOM;SG	jeftin|oća
jemstvo	N;ACC;SG	jem|stvo
jesenski	ADJ;MASC;VOC;SG	jesen|ski
jetrica	N;NOM;SG	jetr|ica
jezgrica	N;NOM;SG	jezgr|ica
južina	N;NOM;SG	juž|ina
kadilo	V.PTCP;PASS;PST;SG;NEUT	kadi|lo
kadionica	N;NOM;SG	kadio|nica
kamen	N;ACC;SG	kam|en
karanfilić	N;ACC;SG	karanfil|ić
katranski	ADJ;MASC;VOC;SG	katran|ski
kemijski	ADJ;MASC;VOC;SG	kemij|ski
kilogram	N;ACC;SG	kil|o|gram
kišan	ADJ;INDF;MASC;NOM;SG	kiš|an
kišnica	N;NOM;SG	kiš|nica
klavirist	N;NOM;SG	klavir|ist
klaviristica	N;NOM;SG	klavirist|ica
klaviristkinja	N;NOM;SG	klavirist|kinja
klipnjača	N;NOM;SG	klip|njača
klobučar	N;NOM;SG	klobuč|ar
knjižara	N;NOM;SG	knjižar|a
knjižničar	N;NOM;SG	knjižnič|ar
knjižničarstvo	N;ACC;SG	knjižničar|stvo
komadić	N;ACC;SG	komad|ić
konobarica	N;NOM;SG	konobar|ica
konopac	N;ACC;SG	konop|ac
kovačica	N;NOM;SG	kovač|ica
kovinotokar	N;NOM;SG	kovin|o|tokar
kozarstvo	N;ACC;SG	kozar|stvo
košarka	N;NOM;SG	košar|ka
kožar	N;NOM;SG	kož|ar
kožica	N;NOM;SG	kož|ica
krajnik	N;ACC;SG	kraj|nik
kraljevstvo	N;ACC;SG	kraljev|stvo
kratkodnevica	N;NOM;SG	kratk|o|dnevica
kratkometni	ADJ;MASC;VOC;SG	kratk|o|metni
kratkometražni	ADJ;MASC;VOC;SG	kratk|o|metražni
kratkonog	ADJ;INDF;MASC;ACC;SG;INAN	kratk|o|nog
kratkovalni	ADJ;MASC;VOC;SG	kratk|o|valni
kratkovid	ADJ;INDF;MASC;ACC;SG;INAN	kratk|o|vid
kriptotehnofobija	N;NOM;SG	kript|o|tehnofobija
krivica	N;NOM;SG	kriv|ica
krkanluk	N;ACC;SG	krkan|luk
krojačica	N;NOM;SG	krojač|ica
kroničar	N;NOM;SG	kroni|čar
krumpirište	N;ACC;SG	krumpir|ište
krčmar	N;NOM;SG	krčm|ar
kuca	V;PRS;3;SG	ku|ca
kuhalo	V.PTCP;ACT;PST;SG;NEUT	kuha|lo
kućica	N;NOM;SG	kuć|ica
kvačica	N;NOM;SG	kvač|ica
lagano	ADJ;INDF;NEUT;VOC;SG	lagan|o
lavež	N;ACC;SG	lav|ež
lavica	N;NOM;SG	lav|ica
leden	ADJ;INDF;MASC;NOM;SG	led|en
lepak	N;ACC;SG	lep|ak
lepilo	V.PTCP;ACT;PST;SG;NEUT	lep|ilo
lepota	N;NOM;SG	lep|ota
lepotica	N;NOM;SG	lepot|ica
lešina	N;NOM;SG	leš|ina
lešinar	N;NOM;SG	lešin|ar
lijenost	N;ACC;SG	lijen|ost
liječnik	N;NOM;SG	liječ|nik
lipanjski	ADJ;MASC;VOC;SG	lipanj|ski
listopadski	ADJ;MASC;VOC;SG	listopad|ski
lizalica	N;NOM;SG	liza|lica
ljepota	N;NOM;SG	ljep|ota
ljepotan	N;NOM;SG	ljepot|an
ljubavnik	N;NOM;SG	ljubav|nik
ljubomoran	ADJ;INDF;MASC;NOM;SG	ljubomor|an
lonče	N;ACC;SG	lon|če
lopovski	ADJ;MASC;VOC;SG	lopov|ski
lovočuvarski	ADJ;MASC;VOC;SG	lovočuvar|ski
luckasto	ADJ;INDF;NEUT;VOC;SG	luckast|o
luckastost	N;ACC;SG	luckast|ost
lutalica	N;GEN;PL	luta|lica
macan	N;NOM;SG	mac|an
magija	N;NOM;SG	mag|ija
maglica	N;NOM;SG	magl|ica
magnetit	N;ACC;SG	magnet|it
malen	ADJ;INDF;MASC;NOM;SG	mal|en
maloprodaja	N;NOM;SG	mal|o|prodaja
maramica	N;NOM;SG	maram|ica
marifetluk	N;ACC;SG	marifet|luk
mesar	N;NOM;SG	mes|ar
milimetar	N;ACC;SG	mil|i|metar
mirno	ADJ;INDF;NEUT;VOC;SG	mir|no
miran	ADJ;INDF;MASC;NOM;SG	mir|an
mirisan	ADJ;INDF;MASC;ACC;SG;INAN	miris|an
misirski	ADJ;MASC;VOC;SG	misir|ski
mišar	N;NOM;SG	miš|ar
mišić	N;ACC;SG	miš|ić
mjerilo	V.PTCP;ACT;PST;SG;NEUT	mjeri|lo
mladost	N;ACC;SG	mlad|ost
mlinar	N;NOM;SG	mlin|ar
abdomenski	ADJ;MASC;VOC;SG	abdomen|ski
moćnik	N;NOM;SG	moć|nik
muzejski	ADJ;MASC;VOC;SG	muzej|ski
muževnost	N;ACC;SG	muževn|ost
ablaut	N;ACC;SG	a|b|laut
nabiti	V.PTCP;PASS;PST;PL;MASC	n|a|biti
nabreknuti	V.PTCP;PASS;PST;PL;MASC	n|a|breknuti
nadahnuti	V.PTCP;PASS;PST;PL;MASC	n|a|dahnuti
nadenuti	V.PTCP;PASS;PST;PL;MASC	n|a|denuti
nadjenuti	V.PTCP;PASS;PST;PL;MASC	n|a|djenuti
nadlaktica	N;NOM;SG	na|d|laktica
nadviti	V.PTCP;PASS;PST;PL;MASC	na|d|viti
nadvodni	ADJ;MASC;VOC;SG	na|d|vodni
nadvojvoda	N;GEN;PL	na|d|vojvoda
naglasak	N;ACC;SG	n|a|glasak
abnormalno	ADJ;INDF;NEUT;VOC;SG	a|b|normalno
abnormalan	ADJ;INDF;MASC;ACC;SG;INAN	a|b|normalan
naglavak	N;ACC;SG	n|a|glavak
abnormalnost	N;ACC;SG	abnormaln|ost
nagovor	N;ACC;SG	n|a|govor
namaknuti	V.PTCP;PASS;PST;PL;MASC	n|a|maknuti
namera	N;NOM;SG	n|a|mera
namjera	N;NOM;SG	n|a|mjera
naočale	N;ACC;SG	n|a|očale
napasti	N;VOC;PL	n|a|pasti
narod	N;ACC;SG	n|a|rod
nastavnica	N;NOM;SG	nastavn|ica
naum	N;ACC;SG	n|a|um
načelnik	N;NOM;SG	n|a|čelnik
nebog	ADJ;INDF;MASC;NOM;SG	n|e|bog
nedavno	ADJ;INDF;NEUT;VOC;SG	n|e|davno
negostoljubivost	N;ACC;SG	n|e|gostoljubivost
neiskusan	ADJ;INDF;MASC;NOM;SG	n|e|iskusan
neizbrisiv	ADJ;INDF;MASC;ACC;SG;INAN	n|e|izbrisiv
neizrečen	ADJ;INDF;MASC;ACC;SG;INAN	n|e|izrečen
neizvediv	ADJ;INDF;MASC;ACC;SG;INAN	n|e|izvediv
nejak	ADJ;INDF;MASC;ACC;SG;INAN	n|e|jak
nejasnost	N;ACC;SG	n|e|jasnost
nejedinstvo	N;ACC;SG	n|e|jedinstvo
nejednakost	N;ACC;SG	nejednak|ost
nejednolik	ADJ;INDF;MASC;ACC;SG;INAN	n|e|jednolik
nekakav	ADJ;INDF;MASC;ACC;SG;INAN	n|e|kakav
nekomunikativan	ADJ;INDF;MASC;ACC;SG;INAN	n|e|komunikativan
nekonvencionalan	ADJ;INDF;MASC;ACC;SG;INAN	n|e|konvencionalan
nekoristan	ADJ;INDF;MASC;NOM;SG	n|e|koristan
nekretnina	N;NOM;SG	n|e|kretnina
nekuhan	ADJ;INDF;MASC;ACC;SG;INAN	n|e|kuhan
nekvalitetan	ADJ;INDF;MASC;ACC;SG;INAN	n|e|kvalitetan
nelagodan	ADJ;INDF;MASC;ACC;SG;INAN	n|e|lagodan
neloš	ADJ;INDF;MASC;ACC;SG;INAN	n|e|loš
nemar	N;ACC;SG	n|e|mar
nemarno	ADJ;INDF;NEUT;VOC;SG	n|e|marno
nemaran	ADJ;INDF;MASC;NOM;SG	n|e|maran
nemaštovit	ADJ;INDF;MASC;ACC;SG;INAN	n|e|maštovit
nemerljiv	ADJ;INDF;MASC;ACC;SG;INAN	n|e|merljiv
nemio	ADJ;INDF;MASC;NOM;SG	n|e|mio
nemjerljiv	ADJ;INDF;MASC;ACC;SG;INAN	n|e|mjerljiv
nemoderan	ADJ;INDF;MASC;ACC;SG;INAN	n|e|moderan
nemoguće	ADJ;INDF;FEM;GEN;SG	nemoguć|e
nenormalan	ADJ;INDF;MASC;ACC;SG;INAN	n|e|normalan
neoboriv	ADJ;INDF;MASC;ACC;SG;INAN	n|e|oboriv
neodgovorno	ADJ;INDF;NEUT;VOC;SG	n|e|odgovorno
neodgovornost	N;ACC;SG	n|e|odgovornost
neograničen	ADJ;INDF;MASC;ACC;SG;INAN	n|e|ograničen
neopipljiv	ADJ;INDF;MASC;ACC;SG;INAN	n|e|opipljiv
neoporeziv	ADJ;INDF;MASC;ACC;SG;INAN	n|e|oporeziv
neoporezovan	ADJ;INDF;MASC;ACC;SG;INAN	n|e|oporezovan
neosoban	ADJ;INDF;MASC;ACC;SG;INAN	n|e|osoban
neovisno	ADJ;INDF;NEUT;VOC;SG	n|e|ovisno
neovisan	ADJ;INDF;MASC;NOM;SG	n|e|ovisan
nepotreban	ADJ;INDF;MASC;NOM;SG	n|e|potreban
nepovratan	ADJ;INDF;MASC;ACC;SG;INAN	n|e|povratan
nepovrediv	ADJ;INDF;MASC;ACC;SG;INAN	n|e|povrediv
nepoželjan	ADJ;INDF;MASC;ACC;SG;INAN	n|e|poželjan
nepravda	N;NOM;SG	n|e|pravda
neprimeren	ADJ;INDF;MASC;ACC;SG;INAN	n|e|primeren
neprimjeren	ADJ;INDF;MASC;ACC;SG;INAN	n|e|primjeren
nepripremljen	ADJ;INDF;MASC;ACC;SG;INAN	n|e|pripremljen
nepristojan	ADJ;INDF;MASC;NOM;SG	n|e|pristojan
nepristran	ADJ;INDF;MASC;ACC;SG;INAN	n|e|pristran
neprobavljen	ADJ;INDF;MASC;ACC;SG;INAN	n|e|probavljen
neprodan	ADJ;INDF;MASC;ACC;SG;INAN	n|e|prodan
neprofesionalan	ADJ;INDF;MASC;ACC;SG;INAN	n|e|profesionalan
neprofitan	ADJ;INDF;MASC;ACC;SG;INAN	n|e|profitan
neprokušan	ADJ;INDF;MASC;ACC;SG;INAN	n|e|prokušan
nepromenjen	ADJ;INDF;MASC;ACC;SG;INAN	n|e|promenjen
nepromijenjen	ADJ;INDF;MASC;ACC;SG;INAN	n|e|promijenjen
nepromišljen	ADJ;INDF;MASC;ACC;SG;INAN	n|e|promišljen
nepropustan	ADJ;INDF;MASC;ACC;SG;INAN	n|e|propustan
neproveren	ADJ;INDF;MASC;ACC;SG;INAN	n|e|proveren
neprovidan	ADJ;INDF;MASC;ACC;SG;INAN	n|e|providan
neprovjeren	ADJ;INDF;MASC;ACC;SG;INAN	n|e|provjeren
nerabljen	ADJ;INDF;MASC;ACC;SG;INAN	n|e|rabljen
nerafiniran	ADJ;INDF;MASC;ACC;SG;INAN	n|e|rafiniran
nerazdruživ	ADJ;INDF;MASC;ACC;SG;INAN	n|e|razdruživ
nerazgovetan	ADJ;INDF;MASC;ACC;SG;INAN	n|e|razgovetan
nerazgovijetan	ADJ;INDF;MASC;ACC;SG;INAN	n|e|razgovijetan
nerazumljiv	ADJ;INDF;MASC;NOM;SG	n|e|razumljiv
nerazvodnjen	ADJ;INDF;MASC;ACC;SG;INAN	n|e|razvodnjen
nerealiziran	ADJ;INDF;MASC;ACC;SG;INAN	n|e|realiziran
nerođen	ADJ;INDF;MASC;ACC;SG;INAN	n|e|rođen
nesagoriv	ADJ;INDF;MASC;ACC;SG;INAN	n|e|sagoriv
nesalomljiv	ADJ;INDF;MASC;ACC;SG;INAN	n|e|salomljiv
nesamostalan	ADJ;INDF;MASC;NOM;SG	n|e|samostalan
nesavestan	ADJ;INDF;MASC;NOM;SG	n|e|savestan
nesavjestan	ADJ;INDF;MASC;NOM;SG	n|e|savjestan
nesimetričan	ADJ;INDF;MASC;ACC;SG;INAN	n|e|simetričan
neskromnost	N;ACC;SG	n|e|skromnost
nesreća	N;NOM;SG	n|e|sreća
nestabilnost	N;ACC;SG	n|e|stabilnost
nesvestan	ADJ;INDF;MASC;ACC;SG;INAN	n|e|svestan
nesvjestan	ADJ;INDF;MASC;ACC;SG;INAN	n|e|svjestan
neuporabljiv	ADJ;INDF;MASC;ACC;SG;INAN	n|e|uporabljiv
neuravnotežen	ADJ;INDF;MASC;NOM;SG	n|e|uravnotežen
neutaživ	ADJ;INDF;MASC;ACC;SG;INAN	n|e|utaživ
nezahvalnost	N;ACC;SG	n|e|zahvalnost
nezavisno	ADJ;INDF;NEUT;VOC;SG	n|e|zavisno
nezavisan	ADJ;INDF;MASC;NOM;SG	n|e|zavisan
nezgoda	N;NOM;SG	n|e|zgoda
neznatno	ADJ;INDF;NEUT;VOC;SG	n|e|znatno
neznatan	ADJ;INDF;MASC;NOM;SG	n|e|znatan
nikoji	ADJ;MASC;NOM;PL	n|i|koji
nosić	N;ACC;SG	nos|ić
nosnik	N;NOM;SG	nos|nik
novinarstvo	N;ACC;SG	novinar|stvo
novost	N;ACC;SG	nov|ost
obest	N;ACC;SG	o|best
obijest	N;ACC;SG	o|bijest
obiteljski	ADJ;MASC;VOC;SG	obitelj|ski
oblačina	N;NOM;SG	oblač|ina
oblik	N;ACC;SG	o|b|lik
obožavateljica	N;NOM;SG	obožavatelj|ica
obrada	N;NOM;SG	o|b|rada
obračun	N;ACC;SG	o|b|račun
obris	N;ACC;SG	o|b|ris
obrub	N;ACC;SG	o|b|rub
obuzeti	V.PTCP;PASS;PST;PL;MASC	o|b|uzeti
odbojkašica	N;NOM;SG	odbojkaš|ica
odgovor	N;ACC;SG	o|d|govor
odgovoran	ADJ;INDF;MASC;NOM;SG	odgovor|an
odgovornost	N;ACC;SG	odgovorn|ost
odmaknuti	V.PTCP;PASS;PST;PL;MASC	o|d|maknuti
odrasti	V;IMP;2;SG	o|d|rasti
odskok	N;ACC;SG	o|d|skok
oduzeti	V.PTCP;PASS;PST;PL;MASC	o|d|uzeti
odviti	V.PTCP;PASS;PST;PL;MASC	o|d|viti
odvojenost	N;ACC;SG	odvoje|nost
odzdrav	N;ACC;SG	o|d|zdrav
odškrinuti	V.PTCP;PASS;PST;PL;MASC	o|d|škrinuti
ogledalo	V.PTCP;ACT;PST;SG;NEUT	ogleda|lo
ograda	N;NOM;SG	o|grada
okrenuti	V.PTCP;PASS;PST;PL;MASC	o|krenuti
okrug	N;ACC;SG	o|krug
okrutnost	N;ACC;SG	okrutn|ost
opasnost	N;ACC;SG	opasn|ost
oprezan	ADJ;INDF;MASC;NOM;SG	oprez|an
opsena	N;NOM;SG	o|p|sena
opsjena	N;NOM;SG	o|p|sjena
osjećajan	ADJ;INDF;MASC;NOM;SG	osjećaj|an
otrovan	V.PTCP;PASS;PST;SG;MASC	otrov|an
ovčar	N;NOM;SG	ovč|ar
ovčarstvo	N;ACC;SG	ovčar|stvo
pahuljica	N;NOM;SG	pahulj|ica
pakostan	ADJ;INDF;MASC;ACC;SG;INAN	pakost|an
palatal	N;ACC;SG	palat|al
palež	N;ACC;SG	pal|ež
pametar	N;NOM;SG	pamet|ar
paperje	N;ACC;SG	p|a|perje
parazitologija	N;NOM;SG	parazito|logija
partnerstvo	N;ACC;SG	partner|stvo
pasji	ADJ;MASC;VOC;SG	pas|ji
patnja	N;NOM;SG	pat|nja
paučina	N;ACC;PL	pauč|ina
pecivo	N;ACC;SG	pec|ivo
pekar	N;NOM;SG	pek|ar
pijanistica	N;NOM;SG	pijanist|ica
pitak	ADJ;INDF;MASC;NOM;SG	pit|ak
pivara	N;ACC;SG	piv|ara
pjesnik	N;NOM;SG	pjesn|ik
plemenitost	N;ACC;SG	plemenit|ost
plovan	ADJ;INDF;MASC;ACC;SG;INAN	plov|an
podmorje	N;ACC;SG	po|d|morje
podnaslov	N;ACC;SG	po|d|naslov
podneblje	N;ACC;SG	po|d|neblje
podnositelj	N;NOM;SG	podnosi|telj
podoknica	N;NOM;SG	po|d|oknica
podsmeh	N;ACC;SG	po|d|smeh
podsmijeh	N;ACC;SG	po|d|smijeh
podstanar	N;NOM;SG	po|d|stanar
podstanarka	N;NOM;SG	po|d|stanarka
podstanarski	ADJ;MASC;VOC;SG	podstanar|ski
podsvest	N;ACC;SG	po|d|svest
podsvijest	N;ACC;SG	po|d|svijest
poduzeti	V.PTCP;PASS;PST;PL;MASC	po|d|uzeti
pokoji	N;VOC;PL	p|o|koji
pokrenuti	V.PTCP;PASS;PST;PL;MASC	p|o|krenuti
pokriti	V.PTCP;PASS;PST;PL;MASC	p|o|kriti
polagan	V.PTCP;PASS;PST;SG;MASC	p|o|lagan
polen	N;ACC;SG	pol|en
policijski	ADJ;MASC;VOC;SG	policij|ski
političar	N;NOM;SG	politi|čar
polubog	N;NOM;SG	pol|u|bog
polubrat	N;NOM;SG	pol|u|brat
adrenalinski	ADJ;MASC;VOC;SG	adrenalin|ski
pomaknuti	V.PTCP;PASS;PST;PL;MASC	p|o|maknuti
pomodan	ADJ;INDF;MASC;NOM;SG	p|o|modan
pomoći	N;VOC;PL	p|o|moći
ponosno	ADJ;INDF;NEUT;VOC;SG	ponos|no
ponosan	ADJ;INDF;MASC;NOM;SG	ponos|an
ponositi	ADJ;DEF;MASC;NOM;PL	ponos|iti
popodne	N;ACC;SG	p|o|podne
poprati	V;PRS;3;SG	p|o|prati
porasti	V;IMP;2;SG	p|o|rasti
porod	N;ACC;SG	p|o|rod
poruga	N;NOM;SG	p|o|ruga
postignuti	V.PTCP;PASS;PST;PL;MASC	p|o|stignuti
posvemašnji	ADJ;MASC;VOC;SG	posvema|šnji
potišten	ADJ;INDF;MASC;NOM;SG	p|o|tišten
potok	N;ACC;SG	p|o|tok
potomstvo	N;ACC;SG	potom|stvo
potporučnik	N;NOM;SG	po|t|poručnik
potpredsednica	N;NOM;SG	po|t|predsednica
potpredsednik	N;NOM;SG	po|t|predsednik
potpredsjednica	N;NOM;SG	po|t|predsjednica
potpredsjednik	N;NOM;SG	po|t|predsjednik
potpredśednica	N;NOM;SG	po|t|predśednica
potpredśednik	N;NOM;SG	po|t|predśednik
potpukovnik	N;NOM;SG	po|t|pukovnik
povest	N;ACC;SG	p|o|vest
povijest	N;ACC;SG	p|o|vijest
povisok	ADJ;INDF;MASC;ACC;SG;INAN	p|o|visok
poviti	V.PTCP;PASS;PST;PL;MASC	p|o|viti
pozdrav	N;ACC;SG	p|o|zdrav
poznati	V.PTCP;PASS;PST;PL;MASC	p|o|znati
pozorište	N;ACC;SG	pozor|ište
počast	N;ACC;SG	p|o|čast
pošto	N;VOC;SG	p|o|što
poštar	N;NOM;SG	pošt|ar
požar	N;ACC;SG	p|o|žar
pradeda	N;ACC;SG	pr|a|deda
praded	N;NOM;SG	pr|a|ded
praistorija	N;NOM;SG	pr|a|istorija
praroditelj	N;NOM;SG	pr|a|roditelj
prastar	ADJ;INDF;MASC;ACC;SG;INAN	pr|a|star
praunuk	N;NOM;SG	pr|a|unuk
pravnica	N;NOM;SG	pravn|ica
praznina	N;NOM;SG	prazn|ina
prašuma	N;NOM;SG	pr|a|šuma
prdež	N;ACC;SG	prd|ež
prebiti	V.PTCP;PASS;PST;PL;MASC	pr|e|biti
predsjednica	N;NOM;SG	predsjedn|ica
predstava	N;NOM;SG	pre|d|stava
predzadnji	ADJ;MASC;VOC;SG	pre|d|zadnji
predznak	N;ACC;SG	pre|d|znak
predznanje	N;ACC;SG	pre|d|znanje
predškola	N;NOM;SG	pre|d|škola
predživot	N;ACC;SG	pre|d|život
prefrigan	ADJ;INDF;MASC;NOM;SG	pr|e|frigan
preglas	N;ACC;SG	pr|e|glas
pregled	N;ACC;SG	pr|e|gled
prekrasan	ADJ;INDF;MASC;ACC;SG;INAN	pr|e|krasan
prelazan	ADJ;INDF;MASC;ACC;SG;INAN	prelaz|an
preljub	N;ACC;SG	pr|e|ljub
preokrenuti	V.PTCP;PASS;PST;PL;MASC	pr|e|okrenuti
preoteti	V.PTCP;PASS;PST;PL;MASC	pr|e|oteti
preporod	N;ACC;SG	pr|e|porod
prepoznati	V.PTCP;PASS;PST;PL;MASC	pr|e|poznati
prerasti	V;IMP;2;SG	pr|e|rasti
preračunati	V.PTCP;PASS;PST;PL;MASC	pr|e|računati
presahnuti	V.PTCP;PASS;PST;PL;MASC	pr|e|sahnuti
prestignuti	V.PTCP;PASS;PST;PL;MASC	pr|e|stignuti
preuzeti	V.PTCP;PASS;PST;PL;MASC	pr|e|uzeti
pridjevski	ADJ;MASC;VOC;SG	pridjev|ski
pridobiti	V.PTCP;PASS;PST;PL;MASC	pr|i|dobiti
pridoneti	V.PTCP;PASS;PST;PL;MASC	pr|i|doneti
pridonijeti	V.PTCP;PASS;PST;PL;MASC	pr|i|donijeti
prijamnik	N;ACC;SG	prijam|nik
prijateljica	N;NOM;SG	prijatelj|ica
prijateljski	ADJ;MASC;VOC;SG	prijatelj|ski
prijateljstvo	N;ACC;SG	prijatelj|stvo
prijeglas	N;ACC;SG	prij|e|glas
prijelazan	ADJ;INDF;MASC;ACC;SG;INAN	prijelaz|an
prijemnik	N;ACC;SG	prijem|nik
prijepodne	N;ACC;SG	prij|e|podne
primaknuti	V.PTCP;PASS;PST;PL;MASC	pr|i|maknuti
primerak	N;ACC;SG	primer|ak
primjerak	N;ACC;SG	primjer|ak
primjeren	ADJ;INDF;MASC;NOM;SG	primjer|en
princeza	N;NOM;SG	princ|eza
prirodoznanstvo	N;ACC;SG	prirodo|znanstvo
prisegnuti	V.PTCP;PASS;PST;PL;MASC	pr|i|segnuti
pristići	V;FUT;1;SG	pr|i|stići
pristignuti	V.PTCP;PASS;PST;PL;MASC	pr|i|stignuti
pristojnost	N;ACC;SG	pristojn|ost
priznati	V.PTCP;PASS;PST;PL;MASC	pr|i|znati
prizor	N;ACC;SG	pr|i|zor
prljavica	N;NOM;SG	prljav|ica
prodekan	N;NOM;SG	pr|o|dekan
prognanica	N;NOM;SG	prognan|ica
progonstvo	N;ACC;SG	progon|stvo
prokleti	V.PTCP;PASS;PST;PL;MASC	pr|o|kleti
promaknuti	V.PTCP;PASS;PST;PL;MASC	pr|o|maknuti
proniknuti	V.PTCP;PASS;PST;PL;MASC	pr|o|niknuti
propasti	N;VOC;PL	pr|o|pasti
propuh	N;ACC;SG	pr|o|puh
proslava	N;NOM;SG	pr|o|slava
prostran	ADJ;INDF;MASC;NOM;SG	prostr|an
prostranstvo	N;ACC;SG	prostran|stvo
proteći	V;FUT;1;SG	pr|o|teći
protivnapad	N;ACC;SG	proti|v|napad
protivnica	N;NOM;SG	protivn|ica
protunapad	N;ACC;SG	prot|u|napad
protuteža	N;NOM;SG	prot|u|teža
proćelav	ADJ;INDF;MASC;ACC;SG;INAN	pr|o|ćelav
prožeti	V.PTCP;PASS;PST;PL;MASC	pr|o|žeti
prsten	N;ACC;SG	prst|en
ptičar	N;NOM;SG	ptič|ar
punokrvan	ADJ;INDF;MASC;NOM;SG	pun|o|krvan
punomoć	N;ACC;SG	pun|o|moć
pupak	N;ACC;SG	pup|ak
pustinjski	ADJ;MASC;VOC;SG	pustinj|ski
pčelar	N;NOM;SG	pčel|ar
pčelarstvo	N;ACC;SG	pčelar|stvo
pčelica	N;NOM;SG	pčel|ica
radioprijemnik	N;ACC;SG	radi|o|prijemnik
radiostanica	N;NOM;SG	radi|o|stanica
ranoranilac	N;NOM;SG	ran|o|ranilac
ratarstvo	N;ACC;SG	ratar|stvo
ratnik	N;NOM;SG	rat|nik
razbiti	V.PTCP;PASS;PST;PL;MASC	ra|z|biti
razbludan	ADJ;INDF;MASC;NOM;SG	ra|z|bludan
razbojnica	N;NOM;SG	razbojn|ica
razborit	ADJ;INDF;MASC;NOM;SG	razbor|it
razdoblje	N;ACC;SG	ra|z|doblje
razgovor	N;ACC;SG	ra|z|govor
razmaknuti	V.PTCP;PASS;PST;PL;MASC	ra|z|maknuti
raznostran	ADJ;INDF;MASC;ACC;SG;INAN	razn|o|stran
razodenuti	V.PTCP;PASS;PST;PL;MASC	ra|z|odenuti
razodjenuti	V.PTCP;PASS;PST;PL;MASC	ra|z|odjenuti
razotkriti	V.PTCP;PASS;PST;PL;MASC	ra|z|otkriti
razuman	ADJ;INDF;MASC;NOM;SG	razum|an
razumljiv	ADJ;INDF;MASC;NOM;SG	razum|ljiv
razumnost	N;ACC;SG	razumn|ost
redistribucija	N;NOM;SG	r|e|distribucija
reintrodukcija	N;NOM;SG	r|e|introdukcija
retkost	N;ACC;SG	retk|ost
rečnik	N;ACC;SG	reč|nik
ribar	N;NOM;SG	rib|ar
ribica	N;NOM;SG	rib|ica
rijetkost	N;ACC;SG	rijetk|ost
rječnik	N;VOC;SG	rječ|nik
rujanski	ADJ;MASC;VOC;SG	rujan|ski
rukavac	N;ACC;SG	rukav|ac
rukopis	N;ACC;SG	ruko|pis
rupetina	N;NOM;SG	rup|etina
rupica	N;NOM;SG	rup|ica
ručetina	N;NOM;SG	ruč|etina
ručica	N;NOM;SG	ruč|ica
saharoza	N;NOM;SG	sahar|oza
skriti	V.PTCP;PASS;PST;PL;MASC	s|kriti
samobitan	ADJ;INDF;MASC;NOM;SG	sam|o|bitan
samokres	N;ACC;SG	sam|o|kres
samoobrana	N;NOM;SG	sam|o|obrana
samooplodnja	N;NOM;SG	sam|o|oplodnja
samoposluga	N;NOM;SG	sam|o|posluga
samoubojica	N;NOM;SG	sam|o|ubojica
samoubojstvo	N;ACC;SG	sam|o|ubojstvo
samovolja	N;NOM;SG	sam|o|volja
samozadovoljan	ADJ;INDF;MASC;NOM;SG	sam|o|zadovoljan
samozaštita	N;NOM;SG	sam|o|zaštita
samozvan	ADJ;INDF;MASC;ACC;SG;INAN	sam|o|zvan
sapunica	N;NOM;SG	sapun|ica
satnik	N;NOM;SG	sat|nik
saznati	V.PTCP;PASS;PST;PL;MASC	s|a|znati
sažetak	N;ACC;SG	sažet|ak
sažeti	V.PTCP;PASS;PST;PL;MASC	s|a|žeti
sekirica	N;NOM;SG	sekir|ica
seksualnost	N;ACC;SG	seksualn|ost
seljačina	N;GEN;PL	seljač|ina
sentimentalno	ADJ;INDF;NEUT;VOC;SG	sentiment|alno
sentimentalnost	N;ACC;SG	sentimental|nost
sferičan	ADJ;INDF;MASC;ACC;SG;INAN	sfer|ičan
akcijski	ADJ;MASC;VOC;SG	akcij|ski
siječanjski	ADJ;MASC;VOC;SG	siječanj|ski
siledžija	N;NOM;SG	sil|edžija
singlica	N;NOM;SG	singl|ica
sirilo	V.PTCP;ACT;PST;SG;NEUT	siri|lo
situacijski	ADJ;MASC;VOC;SG	situacij|ski
sjekiretina	N;NOM;SG	sjekir|etina
sjekirica	N;NOM;SG	sjekir|ica
skrenuti	V.PTCP;PASS;PST;PL;MASC	s|krenuti
skromnost	N;ACC;SG	skromn|ost
slabost	N;ACC;SG	slab|ost
slastičarna	N;NOM;SG	slastičar|na
slijepac	N;NOM;SG	slijep|ac
slika	V;PRS;3;SG	s|lika
sličan	ADJ;INDF;MASC;NOM;SG	slič|an
sličnost	N;ACC;SG	sličn|ost
slobodan	ADJ;INDF;MASC;NOM;SG	slobod|an
slonica	N;NOM;SG	slon|ica
slovnica	N;NOM;SG	slovn|ica
smaknuti	V.PTCP;PASS;PST;PL;MASC	s|maknuti
smesti	V;PRS;3;SG	s|mesti
smisao	N;ACC;SG	s|misao
smisleno	ADJ;INDF;NEUT;VOC;SG	smislen|o
smrtan	ADJ;INDF;MASC;ACC;SG;INAN	smrt|an
smrtnik	N;NOM;SG	smrt|nik
snajperist	N;NOM;SG	snajper|ist
spavalica	N;NOM;SG	spava|lica
spisateljica	N;NOM;SG	spisatelj|ica
sportski	ADJ;MASC;VOC;SG	sport|ski
spoznati	V.PTCP;PASS;PST;PL;MASC	s|poznati
sračunati	V.PTCP;PASS;PST;PL;MASC	s|računati
srpanjski	ADJ;MASC;VOC;SG	srpanj|ski
staklar	N;NOM;SG	stakl|ar
stanarski	ADJ;MASC;VOC;SG	stanar|ski
starac	N;NOM;SG	star|ac
starešina	N;NOM;SG	star|ešina
starica	N;NOM;SG	star|ica
starješina	N;NOM;SG	starj|ešina
starost	N;ACC;SG	star|ost
stisnuti	V.PTCP;PASS;PST;PL;MASC	s|tisnuti
stolnjak	N;ACC;SG	stol|njak
stočarstvo	N;ACC;SG	stočar|stvo
stražar	N;NOM;SG	straž|ar
stričev	ADJ;MASC;VOC;SG	strič|ev
strpljivost	N;ACC;SG	strpljiv|ost
stupić	N;ACC;SG	stup|ić
stvar	N;ACC;SG	s|tvar
stvarnost	N;ACC;SG	stvar|nost
sudstvo	N;ACC;SG	sud|stvo
sukob	N;ACC;SG	s|u|kob
sumaglica	N;NOM;SG	s|u|maglica
supruga	N;NOM;SG	suprug|a
suseda	N;NOM;SG	sused|a
susedstvo	N;ACC;SG	sused|stvo
susjeda	N;NOM;SG	susjed|a
susjedstvo	N;ACC;SG	susjed|stvo
sustignuti	V.PTCP;PASS;PST;PL;MASC	s|u|stignuti
suzan	ADJ;INDF;MASC;NOM;SG	suz|an
svadljivost	N;ACC;SG	svadljiv|ost
svetica	N;NOM;SG	svet|ica
svetitelj	N;NOM;SG	sveti|telj
sveučilište	N;ACC;SG	sv|e|učilište
sveza	V;PROG;PST;2;SG	s|veza
svibanjski	ADJ;MASC;VOC;SG	svibanj|ski
svinjetina	N;NOM;SG	svinj|etina
svojstvo	N;ACC;SG	svoj|stvo
alkoholija	N;NOM;SG	alkohol|ija
alkoholizam	N;ACC;SG	alkohol|izam
tatica	N;NOM;SG	tat|ica
telefonist	N;NOM;SG	telefon|ist
televizija	N;NOM;SG	tel|e|vizija
tenkist	N;NOM;SG	tenk|ist
terminologija	N;NOM;SG	termino|logija
tiho	ADJ;INDF;NEUT;VOC;SG	tih|o
tipkovnica	N;NOM;SG	tipk|ovnica
tisućnik	N;NOM;SG	tisuć|nik
traumatologija	N;NOM;SG	traumato|logija
travanjski	ADJ;MASC;VOC;SG	travanj|ski
trkačica	N;NOM;SG	trkač|ica
tužitelj	N;NOM;SG	tuži|telj
tužiteljica	N;NOM;SG	tužitelj|ica
tvrdica	N;NOM;SG	tvrd|ica
tvrdokoran	ADJ;INDF;MASC;NOM;SG	tvrd|o|koran
tvrdoća	N;NOM;SG	tvrd|oća
udahnuti	V.PTCP;PASS;PST;PL;MASC	u|dahnuti
udati	ADJ;DEF;MASC;NOM;PL	u|dati
udolina	N;NOM;SG	u|dolina
udovica	N;NOM;SG	udov|ica
ukleti	V.PTCP;PASS;PST;PL;MASC	u|kleti
ulazak	N;ACC;SG	ulaz|ak
umetnuti	V.PTCP;PASS;PST;PL;MASC	u|metnuti
umiti	V.PTCP;PASS;PST;PL;MASC	u|miti
umnjak	N;ACC;SG	um|njak
unuka	N;NOM;SG	unuk|a
upiti	N;VOC;PL	u|piti
upitan	V.PTCP;PASS;PST;SG;MASC	upit|an
upoznati	V.PTCP;PASS;PST;PL;MASC	u|poznati
uputa	N;NOM;SG	u|puta
uračunati	V.PTCP;PASS;PST;PL;MASC	u|računati
urod	N;ACC;SG	u|rod
useljenik	N;NOM;SG	uselje|nik
ustav	N;ACC;SG	u|stav
utok	N;ACC;SG	u|tok
utovar	N;ACC;SG	u|tovar
uviti	V.PTCP;PASS;PST;PL;MASC	u|viti
uzajaman	ADJ;INDF;MASC;ACC;SG;INAN	u|z|ajaman
uzastopan	ADJ;INDF;MASC;ACC;SG;INAN	u|zastopan
učenica	N;NOM;SG	učen|ica
učitelj	N;NOM;SG	uči|telj
učiteljica	N;DAT;PL	učitelj|ica
učiteljski	ADJ;MASC;VOC;SG	učitelj|ski
uštinuti	V.PTCP;PASS;PST;PL;MASC	u|štinuti
anacionalan	ADJ;INDF;MASC;ACC;SG;INAN	a|nacionalan
vekerica	N;NOM;SG	veker|ica
veleposlanstvo	N;ACC;SG	vel|e|poslanstvo
velikan	N;NOM;SG	velik|an
verziranost	N;ACC;SG	verziran|ost
vikendica	N;NOM;SG	vikend|ica
visak	N;ACC;SG	vis|ak
višeznačan	ADJ;INDF;MASC;ACC;SG;INAN	viš|e|značan
vlasulja	N;NOM;SG	vlas|ulja
voditeljica	N;NOM;SG	voditelj|ica
vratilo	V.PTCP;ACT;PST;SG;NEUT	vrat|ilo
vrtlarev	ADJ;MASC;VOC;SG	vrtlar|ev
vrtlarstvo	N;ACC;SG	vrtlar|stvo
zabrinuti	V.PTCP;PASS;PST;PL;MASC	z|a|brinuti
zadah	N;ACC;SG	z|a|dah
zadovoljan	ADJ;INDF;MASC;NOM;SG	z|a|dovoljan
zakleti	V.PTCP;PASS;PST;PL;MASC	z|a|kleti
zamaknuti	V.PTCP;PASS;PST;PL;MASC	z|a|maknuti
zapregnuti	V.PTCP;PASS;PST;PL;MASC	z|a|pregnuti
zaradi	V;PRS;3;SG	z|a|radi
zaručnica	N;NOM;SG	zaručn|ica
zastavnik	N;NOM;SG	zastav|nik
zatvorenica	N;NOM;SG	zatvoren|ica
zauzeti	V.PTCP;PASS;PST;PL;MASC	z|a|uzeti
začetak	N;ACC;SG	začet|ak
zdravstvo	N;ACC;SG	zdrav|stvo
zemljopis	N;ACC;SG	zemljo|pis
zidarstvo	N;ACC;SG	zidar|stvo
zimnica	N;NOM;SG	zimn|ica
zimski	ADJ;MASC;VOC;SG	zim|ski
zlatoust	ADJ;INDF;MASC;ACC;SG;INAN	zlat|o|ust
zloban	ADJ;INDF;MASC;NOM;SG	zlob|an
zmijolik	ADJ;INDF;MASC;ACC;SG;INAN	zmijo|lik
zmijski	ADJ;MASC;VOC;SG	zmij|ski
znojan	ADJ;INDF;MASC;NOM;SG	znoj|an
zoben	ADJ;INDF;MASC;ACC;SG;INAN	zob|en
zrakoplovstvo	N;ACC;SG	zrakoplov|stvo
zubac	N;ACC;SG	zub|ac
zubar	N;NOM;SG	zub|ar
zubarica	N;NOM;SG	zubar|ica
antialkoholizam	N;ACC;SG	ant|i|alkoholizam
anticiklona	N;NOM;SG	ant|i|ciklona
antiimperijalizam	N;ACC;SG	ant|i|imperijalizam
antikomunist	N;NOM;SG	ant|i|komunist
antireligiozan	ADJ;INDF;MASC;ACC;SG;INAN	ant|i|religiozan
ćorav	ADJ;INDF;MASC;NOM;SG	ćor|av
ćosavost	N;ACC;SG	ćosav|ost
ćudljivost	N;ACC;SG	ćudljiv|ost
ćumurdžija	N;GEN;PL	ćumur|džija
čajnik	N;ACC;SG	čaj|nik
antisocijalan	ADJ;INDF;MASC;ACC;SG;INAN	ant|i|socijalan
antisocijalizam	N;ACC;SG	ant|i|socijalizam
častan	ADJ;INDF;MASC;NOM;SG	čast|an
četvrtak	N;ACC;SG	četvrt|ak
čistost	N;ACC;SG	čist|ost
čistoća	N;NOM;SG	čist|oća
śekirica	N;NOM;SG	śekir|ica
šalica	N;NOM;SG	šal|ica
šarenica	N;NOM;SG	šaren|ica
šarlatanstvo	N;ACC;SG	šarlatan|stvo
šarolik	ADJ;INDF;MASC;NOM;SG	šaro|lik
šašavo	ADJ;INDF;NEUT;VOC;SG	šašav|o
šeširić	N;ACC;SG	šešir|ić
školski	ADJ;MASC;VOC;SG	škol|ski
škripac	N;ACC;SG	škrip|ac
štetan	ADJ;INDF;MASC;NOM;SG	štet|an
štriherica	N;NOM;SG	štrih|erica
šuman	ADJ;INDF;MASC;NOM;SG	šum|an
žabar	N;NOM;SG	žab|ar
žabetina	N;NOM;SG	žab|etina
žabica	N;NOM;SG	žab|ica
žalost	N;ACC;SG	žal|ost
željeznica	N;NOM;SG	željezn|ica
ženski	ADJ;MASC;VOC;SG	žen|ski
ženstvenost	N;ACC;SG	ženstven|ost
životinjski	ADJ;MASC;VOC;SG	životinj|ski
životopis	N;ACC;SG	život|opis
živčan	ADJ;INDF;MASC;NOM;SG	živč|an
župan	N;NOM;SG	žup|an
anđelčić	N;NOM;SG	anđel|čić
anđeoski	ADJ;MASC;VOC;SG	anđeo|ski
абнормалан	ADJ;INDF;MASC;ACC;SG;INAN	а|б|нормалан
анационалан	ADJ;INDF;MASC;ACC;SG;INAN	а|националан
антирелигиозан	ADJ;INDF;MASC;ACC;SG;INAN	ант|и|религиозан
антисоцијалан	ADJ;INDF;MASC;ACC;SG;INAN	ант|и|социјалан
безазлен	ADJ;INDF;MASC;ACC;SG;INAN	бе|з|азлен
безаконит	ADJ;INDF;MASC;ACC;SG;INAN	бе|з|аконит
безалкохолан	ADJ;INDF;MASC;ACC;SG;INAN	бе|з|алкохолан
безбожан	ADJ;INDF;MASC;ACC;SG;INAN	бе|з|божан
безболан	ADJ;INDF;MASC;ACC;SG;INAN	бе|з|болан
безбојан	ADJ;INDF;MASC;ACC;SG;INAN	бе|з|бојан
безбрижан	ADJ;INDF;MASC;ACC;SG;INAN	бе|з|брижан
безбројан	ADJ;INDF;MASC;ACC;SG;INAN	бе|з|бројан
безвезан	ADJ;INDF;MASC;ACC;SG;INAN	бе|з|везан
безверан	ADJ;INDF;MASC;ACC;SG;INAN	бе|з|веран
безводан	ADJ;INDF;MASC;ACC;SG;INAN	бе|з|водан
безвредан	ADJ;INDF;MASC;ACC;SG;INAN	бе|з|вредан
безвремен	ADJ;INDF;MASC;ACC;SG;INAN	бе|з|времен
безвриједан	ADJ;INDF;MASC;ACC;SG;INAN	бе|з|вриједан
безвјеран	ADJ;INDF;MASC;ACC;SG;INAN	бе|з|вјеран
безглав	ADJ;INDF;MASC;ACC;SG;INAN	бе|з|глав
безгласан	ADJ;INDF;MASC;ACC;SG;INAN	бе|з|гласан
безготовински	ADJ;MASC;ACC;SG;INAN	бе|з|готовински
безграничан	ADJ;INDF;MASC;ACC;SG;INAN	бе|з|граничан
безгрешан	ADJ;INDF;MASC;ACC;SG;INAN	бе|з|грешан
бездимни	ADJ;MASC;ACC;SG;INAN	бе|з|димни
безидејан	ADJ;INDF;MASC;ACC;SG;INAN	бе|з|идејан
безизлазан	ADJ;INDF;MASC;ACC;SG;INAN	бе|з|излазан
безизниман	ADJ;INDF;MASC;ACC;SG;INAN	бе|з|изниман
безизражајан	ADJ;INDF;MASC;ACC;SG;INAN	бе|з|изражајан
безначајан	ADJ;INDF;MASC;ACC;SG;INAN	бе|з|начајан
безобзиран	ADJ;INDF;MASC;ACC;SG;INAN	бе|з|обзиран
безобразан	ADJ;INDF;MASC;ACC;SG;INAN	бе|з|образан
безосећајан	ADJ;INDF;MASC;ACC;SG;INAN	бе|з|осећајан
безосјећајан	ADJ;INDF;MASC;ACC;SG;INAN	бе|з|осјећајан
безразложан	ADJ;INDF;MASC;ACC;SG;INAN	бе|з|разложан
безрезерван	ADJ;INDF;MASC;ACC;SG;INAN	бе|з|резерван
безуб	ADJ;INDF;MASC;ACC;SG;INAN	бе|з|уб
безуман	ADJ;INDF;MASC;ACC;SG;INAN	бе|з|уман
библиотекарски	ADJ;MASC;ACC;SG;INAN	библиотекар|ски
билатералан	ADJ;INDF;MASC;ACC;SG;INAN	б|и|латералан
богаташев	ADJ;MASC;ACC;SG;INAN	богаташ|ев
братски	ADJ;MASC;ACC;SG;INAN	брат|ски
apotekar	N;NOM;SG	apotek|ar
вишезначан	ADJ;INDF;MASC;ACC;SG;INAN	виш|е|значан
apsurdnost	N;ACC;SG	apsurdn|ost
градски	ADJ;MASC;ACC;SG;INAN	град|ски
двосмислен	ADJ;INDF;MASC;ACC;SG;INAN	дв|о|смислен
електромагнетни	ADJ;MASC;ACC;SG;INAN	електр|о|магнетни
електромагнетски	ADJ;MASC;ACC;SG;INAN	електр|о|магнетски
животињски	ADJ;MASC;ACC;SG;INAN	животињ|ски
живчан	ADJ;INDF;MASC;ACC;SG;INAN	живч|ан
забринути	ADJ;DEF;MASC;ACC;SG;INAN	з|а|бринути
задовољан	ADJ;INDF;MASC;ACC;SG;INAN	з|а|довољан
златоуст	ADJ;INDF;MASC;ACC;SG;INAN	злат|о|уст
изврстан	ADJ;INDF;MASC;ACC;SG;INAN	и|з|врстан
катрански	ADJ;MASC;ACC;SG;INAN	катран|ски
кратковални	ADJ;MASC;ACC;SG;INAN	кратк|о|вални
кратковид	ADJ;INDF;MASC;ACC;SG;INAN	кратк|о|вид
краткометни	ADJ;MASC;ACC;SG;INAN	кратк|о|метни
краткометражни	ADJ;MASC;ACC;SG;INAN	кратк|о|метражни
кратконог	ADJ;INDF;MASC;ACC;SG;INAN	кратк|о|ног
ловочуварски	ADJ;MASC;ACC;SG;INAN	ловочувар|ски
мален	ADJ;INDF;MASC;ACC;SG;INAN	мал|ен
мисирски	ADJ;MASC;ACC;SG;INAN	мисир|ски
музејски	ADJ;MASC;ACC;SG;INAN	музеј|ски
надводни	ADJ;MASC;ACC;SG;INAN	на|д|водни
небог	ADJ;INDF;MASC;ACC;SG;INAN	н|е|бог
независан	ADJ;INDF;MASC;ACC;SG;INAN	н|е|зависан
незнатан	ADJ;INDF;MASC;ACC;SG;INAN	н|е|знатан
неизбрисив	ADJ;INDF;MASC;ACC;SG;INAN	н|е|избрисив
неизведив	ADJ;INDF;MASC;ACC;SG;INAN	н|е|изведив
неизречен	ADJ;INDF;MASC;ACC;SG;INAN	н|е|изречен
неискусан	ADJ;INDF;MASC;ACC;SG;INAN	н|е|искусан
некакав	ADJ;INDF;MASC;ACC;SG;INAN	н|е|какав
неквалитетан	ADJ;INDF;MASC;ACC;SG;INAN	н|е|квалитетан
некомуникативан	ADJ;INDF;MASC;ACC;SG;INAN	н|е|комуникативан
неконвенционалан	ADJ;INDF;MASC;ACC;SG;INAN	н|е|конвенционалан
некористан	ADJ;INDF;MASC;ACC;SG;INAN	н|е|користан
нелагодан	ADJ;INDF;MASC;ACC;SG;INAN	н|е|лагодан
нелош	ADJ;INDF;MASC;ACC;SG;INAN	н|е|лош
немаран	ADJ;INDF;MASC;ACC;SG;INAN	н|е|маран
немаштовит	ADJ;INDF;MASC;ACC;SG;INAN	н|е|маштовит
немерљив	ADJ;INDF;MASC;ACC;SG;INAN	н|е|мерљив
немио	ADJ;INDF;MASC;ACC;SG;INAN	н|е|мио
немодеран	ADJ;INDF;MASC;ACC;SG;INAN	н|е|модеран
немјерљив	ADJ;INDF;MASC;ACC;SG;INAN	н|е|мјерљив
ненормалан	ADJ;INDF;MASC;ACC;SG;INAN	н|е|нормалан
необорив	ADJ;INDF;MASC;ACC;SG;INAN	н|е|оборив
неограничен	ADJ;INDF;MASC;ACC;SG;INAN	н|е|ограничен
неопипљив	ADJ;INDF;MASC;ACC;SG;INAN	н|е|опипљив
неопорезив	ADJ;INDF;MASC;ACC;SG;INAN	н|е|опорезив
неопорезован	ADJ;INDF;MASC;ACC;SG;INAN	н|е|опорезован
неособан	ADJ;INDF;MASC;ACC;SG;INAN	н|е|особан
неповратан	ADJ;INDF;MASC;ACC;SG;INAN	н|е|повратан
неповредив	ADJ;INDF;MASC;ACC;SG;INAN	н|е|повредив
непожељан	ADJ;INDF;MASC;ACC;SG;INAN	н|е|пожељан
непотребан	ADJ;INDF;MASC;ACC;SG;INAN	н|е|потребан
непримерен	ADJ;INDF;MASC;ACC;SG;INAN	н|е|примерен
непримјерен	ADJ;INDF;MASC;ACC;SG;INAN	н|е|примјерен
неприпремљен	ADJ;INDF;MASC;ACC;SG;INAN	н|е|припремљен
непристојан	ADJ;INDF;MASC;ACC;SG;INAN	н|е|пристојан
непристран	ADJ;INDF;MASC;ACC;SG;INAN	н|е|пристран
непробављен	ADJ;INDF;MASC;ACC;SG;INAN	н|е|пробављен
непроверен	ADJ;INDF;MASC;ACC;SG;INAN	н|е|проверен
непровидан	ADJ;INDF;MASC;ACC;SG;INAN	н|е|провидан
непровјерен	ADJ;INDF;MASC;ACC;SG;INAN	н|е|провјерен
непродан	ADJ;INDF;MASC;ACC;SG;INAN	н|е|продан
непрокушан	ADJ;INDF;MASC;ACC;SG;INAN	н|е|прокушан
непромењен	ADJ;INDF;MASC;ACC;SG;INAN	н|е|промењен
непромишљен	ADJ;INDF;MASC;ACC;SG;INAN	н|е|промишљен
непромијењен	ADJ;INDF;MASC;ACC;SG;INAN	н|е|промијењен
непропустан	ADJ;INDF;MASC;ACC;SG;INAN	н|е|пропустан
непрофесионалан	ADJ;INDF;MASC;ACC;SG;INAN	н|е|професионалан
непрофитан	ADJ;INDF;MASC;ACC;SG;INAN	н|е|профитан
нерабљен	ADJ;INDF;MASC;ACC;SG;INAN	н|е|рабљен
неразводњен	ADJ;INDF;MASC;ACC;SG;INAN	н|е|разводњен
неразговетан	ADJ;INDF;MASC;ACC;SG;INAN	н|е|разговетан
неразговијетан	ADJ;INDF;MASC;ACC;SG;INAN	н|е|разговијетан
нераздружив	ADJ;INDF;MASC;ACC;SG;INAN	н|е|раздружив
неразумљив	ADJ;INDF;MASC;ACC;SG;INAN	н|е|разумљив
нерафиниран	ADJ;INDF;MASC;ACC;SG;INAN	н|е|рафиниран
нереализиран	ADJ;INDF;MASC;ACC;SG;INAN	н|е|реализиран
нерођен	ADJ;INDF;MASC;ACC;SG;INAN	н|е|рођен
несавестан	ADJ;INDF;MASC;ACC;SG;INAN	н|е|савестан
несавјестан	ADJ;INDF;MASC;ACC;SG;INAN	н|е|савјестан
несагорив	ADJ;INDF;MASC;ACC;SG;INAN	н|е|сагорив
несаломљив	ADJ;INDF;MASC;ACC;SG;INAN	н|е|саломљив
несамосталан	ADJ;INDF;MASC;ACC;SG;INAN	н|е|самосталан
несвестан	ADJ;INDF;MASC;ACC;SG;INAN	н|е|свестан
несвјестан	ADJ;INDF;MASC;ACC;SG;INAN	н|е|свјестан
несиметричан	ADJ;INDF;MASC;ACC;SG;INAN	н|е|симетричан
неуравнотежен	ADJ;INDF;MASC;ACC;SG;INAN	н|е|уравнотежен
неутажив	ADJ;INDF;MASC;ACC;SG;INAN	н|е|утажив
нејак	ADJ;INDF;MASC;ACC;SG;INAN	н|е|јак
неједнолик	ADJ;INDF;MASC;ACC;SG;INAN	н|е|једнолик
никоји	ADJ;MASC;ACC;SG;INAN	н|и|који
asimetrija	N;NOM;SG	a|simetrija
asirologija	N;NOM;SG	asiro|logija
опрезан	ADJ;INDF;MASC;ACC;SG;INAN	опрез|ан
пасји	ADJ;MASC;ACC;SG;INAN	пас|ји
повисок	ADJ;INDF;MASC;ACC;SG;INAN	п|о|висок
подстанарски	ADJ;MASC;ACC;SG;INAN	подстанар|ски
познати	ADJ;DEF;MASC;ACC;SG;INAN	п|о|знати
полаган	ADJ;INDF;MASC;ACC;SG;INAN	п|о|лаган
помодан	ADJ;INDF;MASC;ACC;SG;INAN	п|о|модан
посвемашњи	ADJ;MASC;ACC;SG;INAN	посвема|шњи
потиштен	ADJ;INDF;MASC;ACC;SG;INAN	п|о|тиштен
прастар	ADJ;INDF;MASC;ACC;SG;INAN	пр|а|стар
предзадњи	ADJ;MASC;ACC;SG;INAN	пре|д|задњи
прекрасан	ADJ;INDF;MASC;ACC;SG;INAN	пр|е|красан
прелазан	ADJ;INDF;MASC;ACC;SG;INAN	прелаз|ан
префриган	ADJ;INDF;MASC;ACC;SG;INAN	пр|е|фриган
примерен	ADJ;INDF;MASC;ACC;SG;INAN	пример|ен
примјерен	ADJ;INDF;MASC;ACC;SG;INAN	примјер|ен
пријатељски	ADJ;MASC;ACC;SG;INAN	пријатељ|ски
пријелазан	ADJ;INDF;MASC;ACC;SG;INAN	пријелаз|ан
проћелав	ADJ;INDF;MASC;ACC;SG;INAN	пр|о|ћелав
пунокрван	ADJ;INDF;MASC;ACC;SG;INAN	пун|о|крван
пустињски	ADJ;MASC;ACC;SG;INAN	пустињ|ски
разблудан	ADJ;INDF;MASC;ACC;SG;INAN	ра|з|блудан
разборит	ADJ;INDF;MASC;ACC;SG;INAN	разбор|ит
разностран	ADJ;INDF;MASC;ACC;SG;INAN	разн|о|стран
разумљив	ADJ;INDF;MASC;ACC;SG;INAN	разум|љив
самобитан	ADJ;INDF;MASC;ACC;SG;INAN	сам|о|битан
самозадовољан	ADJ;INDF;MASC;ACC;SG;INAN	сам|о|задовољан
самозван	ADJ;INDF;MASC;ACC;SG;INAN	сам|о|зван
ситуацијски	ADJ;MASC;ACC;SG;INAN	ситуациј|ски
смртан	ADJ;INDF;MASC;ACC;SG;INAN	смрт|ан
станарски	ADJ;MASC;ACC;SG;INAN	станар|ски
стричев	ADJ;MASC;ACC;SG;INAN	стрич|ев
тврдокоран	ADJ;INDF;MASC;ACC;SG;INAN	тврд|о|коран
удати	ADJ;DEF;MASC;ACC;SG;INAN	у|дати
узастопан	ADJ;INDF;MASC;ACC;SG;INAN	у|застопан
узајаман	ADJ;INDF;MASC;ACC;SG;INAN	у|з|ајаман
хулигански	ADJ;MASC;ACC;SG;INAN	хулиган|ски
црвенокос	ADJ;INDF;MASC;ACC;SG;INAN	црвен|о|кос
црноок	ADJ;INDF;MASC;ACC;SG;INAN	црн|о|ок
шаролик	ADJ;INDF;MASC;ACC;SG;INAN	шаро|лик
autoportret	N;ACC;SG	aut|o|portret
autorica	N;NOM;SG	autor|ica
autosugestija	N;NOM;SG	aut|o|sugestija
једнодушан	ADJ;INDF;MASC;ACC;SG;INAN	једн|о|душан
једноимен	ADJ;INDF;MASC;ACC;SG;INAN	једн|о|имен
ћорав	ADJ;INDF;MASC;ACC;SG;INAN	ћор|ав
aviokompanija	N;NOM;SG	avi|o|kompanija
badnjak	N;ACC;SG	badnj|ak
banalnost	N;ACC;SG	banaln|ost
batina	V;PRS;3;SG	bat|ina
bačvar	N;NOM;SG	bačv|ar
beskućnica	N;NOM;SG	beskućn|ica
besmisleno	ADJ;INDF;NEUT;VOC;SG	besmislen|o
besmrtnost	N;ACC;SG	besmrtn|ost
besposlenost	N;ACC;SG	besposlen|ost
betonski	ADJ;MASC;VOC;SG	beton|ski
bezakonit	ADJ;INDF;MASC;ACC;SG;INAN	be|z|akonit
bezalkoholan	ADJ;INDF;MASC;ACC;SG;INAN	be|z|alkoholan
bezazlen	ADJ;INDF;MASC;NOM;SG	be|z|azlen
bezbojan	ADJ;INDF;MASC;ACC;SG;INAN	be|z|bojan
bezbolan	ADJ;INDF;MASC;NOM;SG	be|z|bolan
bezbožan	ADJ;INDF;MASC;ACC;SG;INAN	be|z|božan
bezbrižan	ADJ;INDF;MASC;NOM;SG	be|z|brižan
bezbrižnost	N;ACC;SG	bezbrižn|ost
bezbrojan	ADJ;INDF;MASC;ACC;SG;INAN	be|z|brojan
bezdan	N;VOC;SG	be|z|dan
bezdimni	ADJ;MASC;VOC;SG	be|z|dimni
bezdušan	ADJ;INDF;MASC;NOM;SG	be|z|dušan
bezglasan	ADJ;INDF;MASC;ACC;SG;INAN	be|z|glasan
bezglav	ADJ;INDF;MASC;NOM;SG	be|z|glav
bezgotovinski	ADJ;MASC;VOC;SG	be|z|gotovinski
bezgraničan	ADJ;INDF;MASC;ACC;SG;INAN	be|z|graničan
bezgrešan	ADJ;INDF;MASC;ACC;SG;INAN	be|z|grešan
bezidejan	ADJ;INDF;MASC;ACC;SG;INAN	be|z|idejan
bezizlazan	ADJ;INDF;MASC;ACC;SG;INAN	be|z|izlazan
bezizniman	ADJ;INDF;MASC;ACC;SG;INAN	be|z|izniman
bezizražajan	ADJ;INDF;MASC;ACC;SG;INAN	be|z|izražajan
beznačajan	ADJ;INDF;MASC;NOM;SG	be|z|načajan
bezobrazan	ADJ;INDF;MASC;NOM;SG	be|z|obrazan
bezobziran	ADJ;INDF;MASC;NOM;SG	be|z|obziran
bezosećajan	ADJ;INDF;MASC;NOM;SG	be|z|osećajan
bezosjećajan	ADJ;INDF;MASC;NOM;SG	be|z|osjećajan
bezrazložan	ADJ;INDF;MASC;ACC;SG;INAN	be|z|razložan
bezrezervan	ADJ;INDF;MASC;ACC;SG;INAN	be|z|rezervan
bezub	ADJ;INDF;MASC;ACC;SG;INAN	be|z|ub
bezuman	ADJ;INDF;MASC;NOM;SG	be|z|uman
bezuvjetan	ADJ;INDF;MASC;ACC;SG;INAN	be|z|uvjetan
bezveran	ADJ;INDF;MASC;ACC;SG;INAN	be|z|veran
bezvezan	ADJ;INDF;MASC;NOM;SG	be|z|vezan
bezvjeran	ADJ;INDF;MASC;ACC;SG;INAN	be|z|vjeran
bezvlađe	N;ACC;SG	be|z|vlađe
bezvlašće	N;ACC;SG	be|z|vlašće
bezvodan	ADJ;INDF;MASC;ACC;SG;INAN	be|z|vodan
bezvolja	N;NOM;SG	be|z|volja
bezvredan	ADJ;INDF;MASC;NOM;SG	be|z|vredan
bezvremen	ADJ;INDF;MASC;ACC;SG;INAN	be|z|vremen
bezvrijedan	ADJ;INDF;MASC;NOM;SG	be|z|vrijedan
bećaruša	N;NOM;SG	bećar|uša
biciklist	N;NOM;SG	bicikl|ist
bilateralan	ADJ;INDF;MASC;ACC;SG;INAN	b|i|lateralan
biljožderski	ADJ;MASC;VOC;SG	biljožder|ski
biofizika	N;NOM;SG	bi|o|fizika
biokemija	N;NOM;SG	bi|o|kemija
bledilo	N;ACC;SG	bled|ilo
bogatašev	ADJ;MASC;VOC;SG	bogataš|ev
bogatstvo	N;ACC;SG	bogat|stvo
bolan	ADJ;INDF;MASC;NOM;SG	bol|an
bolesnica	N;NOM;SG	bolesn|ica
bolest	N;ACC;SG	bol|est
bolestan	ADJ;INDF;MASC;NOM;SG	bolest|an
bolničar	N;NOM;SG	bolnič|ar
borba	N;NOM;SG	bor|ba
botaničar	N;NOM;SG	botani|čar
bočica	N;NOM;SG	boč|ica
božićni	ADJ;MASC;VOC;SG	božić|ni
bradati	ADJ;DEF;MASC;NOM;PL	brada|ti
bratac	N;NOM;SG	brat|ac
bratić	N;NOM;SG	brat|ić
bratski	ADJ;MASC;VOC;SG	brat|ski
bratstvo	N;ACC;SG	brat|stvo
brodica	N;NOM;SG	brod|ica
brodić	N;ACC;SG	brod|ić
brodski	ADJ;MASC;VOC;SG	brod|ski
brojač	N;ACC;SG	broj|ač
brzo	ADJ;INDF;NEUT;VOC;SG	brz|o
buran	ADJ;INDF;MASC;NOM;SG	bur|an
carina	N;NOM;SG	car|ina
carski	ADJ;MASC;VOC;SG	car|ski
centilitar	N;ACC;SG	cent|i|litar
centimetar	N;ACC;SG	cent|i|metar
cimerica	N;NOM;SG	cimer|ica
crnogorica	N;NOM;SG	crn|o|gorica
crnook	ADJ;INDF;MASC;ACC;SG;INAN	crn|o|ok
crtež	N;ACC;SG	crt|ež
crvenokos	ADJ;INDF;MASC;ACC;SG;INAN	crven|o|kos
cvetak	N;ACC;SG	cvet|ak
cvećarstvo	N;ACC;SG	cvećar|stvo
cvijetak	N;ACC;SG	cvijet|ak
demilitarizacija	N;NOM;SG	d|e|militarizacija
dobrota	N;NOM;SG	dobr|ota
dodirnuti	V.PTCP;PASS;PST;PL;MASC	d|o|dirnuti
dogovor	N;ACC;SG	d|o|govor
domovinski	ADJ;MASC;VOC;SG	domovin|ski
dosadan	ADJ;INDF;MASC;NOM;SG	dosad|an
dosegnuti	V.PTCP;PASS;PST;PL;MASC	d|o|segnuti
dostignuti	V.PTCP;PASS;PST;PL;MASC	d|o|stignuti
dubina	N;NOM;SG	dub|ina
dunjaluk	N;ACC;SG	dunja|luk
dužina	N;NOM;SG	duž|ina
dvogled	N;ACC;SG	dv|o|gled
dvorac	N;ACC;SG	dvor|ac
dvosmislen	ADJ;INDF;MASC;ACC;SG;INAN	dv|o|smislen
dvoženstvo	N;ACC;SG	dv|o|ženstvo
elektromagnet	N;ACC;SG	elektr|o|magnet
elektromagnetizam	N;ACC;SG	elektr|o|magnetizam
elektromagnetni	ADJ;MASC;VOC;SG	elektr|o|magnetni
elektromagnetski	ADJ;MASC;VOC;SG	elektr|o|magnetski
elektromreža	N;NOM;SG	elektr|o|mreža
elektrotehnika	N;NOM;SG	elektr|o|tehnika
enciklopedijski	ADJ;MASC;VOC;SG	enciklopedij|ski
fizioterapija	N;NOM;SG	fizi|o|terapija
fizičar	N;NOM;SG	fizi|čar
fotoaparat	N;ACC;SG	fot|o|aparat
fotoreportaža	N;NOM;SG	fot|o|reportaža
frendica	N;NOM;SG	frend|ica
gitarski	ADJ;MASC;VOC;SG	gitar|ski
gladan	ADJ;INDF;MASC;NOM;SG	glad|an
gladijatorski	ADJ;MASC;VOC;SG	gladijator|ski
glagolski	ADJ;MASC;VOC;SG	glagol|ski
glasno	ADJ;INDF;NEUT;VOC;SG	glas|no
glasan	ADJ;INDF;MASC;NOM;SG	glas|an
glupan	N;NOM;SG	glup|an
golubica	N;NOM;SG	golub|ica
gordost	N;ACC;SG	gord|ost
gradonačelnica	N;NOM;SG	gradonačeln|ica
gradonačelnik	N;NOM;SG	grado|načelnik
gradski	ADJ;MASC;VOC;SG	grad|ski
