ಅಂಗಗಳು	N;PL;NOM	ಅಂಗ|ಗಳು
ಅಂಗಗಳ	N;PL;GEN	ಅಂಗ|ಗ|ಳ
ಅಂಗಗಳನ್ನು	N;PL;ACC	ಅಂಗ|ಗ|ಳ|ನ್ನು
ಅಂಗಡಿಗಳು	N;PL;NOM	ಅಂಗಡಿ|ಗಳು
ಅಂಗಡಿಗಳಿಂದ	N;PL;INS	ಅಂಗಡಿ|ಗಳ|ಿ|ಂದ
ಅಂಗಡಿಗಳ	N;PL;GEN	ಅಂಗಡಿ|ಗ|ಳ
ಅಂಗಡಿಯ	N;SG;GEN	ಅಂಗಡ|ಿ|ಯ
ಅವರು	V;3;PL;FEM;POS	ಅವ|ರ|ು
ನೀವು	V;2;PL;NEG	ನೀ|ವ|ು
ನಾವು	V;1;PL;POS	ನಾ|ವ|ು
ಅಂಟಿನಿಂದ	N;SG;INS	ಅಂಟ|ಿನ|ಿ|ಂದ
ಅವು	V;3;PL;NEUT;NEG	ಅ|ವ|ು
ಅಗ್ನಿಯಿಂದ	N;SG;INS	ಅಗ್ನಿ|ಯ|ಿಂದ
ಅಭ್ಯಾಸದಿಂದ	N;SG;INS	ಅಭ್ಯಾಸ|ದ|ಿ|ಂದ
ಅಭ್ಯಾಸವನ್ನು	N;SG;ACC	ಅಭ್ಯಾಸ|ವ|ನ್ನು
ಅಭ್ಯಾಸದ	N;SG;GEN	ಅಭ್ಯಾ|ಸ|ದ
ಅಭ್ಯಾಸಕ್ಕೆ	N;SG;DAT	ಅಭ್ಯಾಸ|ಕ್ಕೆ
ಆಗಮಿಸುವ	V.PTCP;FUT;LGSPEC1	ಆಗಮಿಸ|ು|ವ
ಆಗಮಿಸಲು	V;NFIN	ಆಗಮ|ಿ|ಸ|ಲ|ು
ಆಗಮಿಸದೆ	V.PTCP;NEG	ಆಗಮ|ಿ|ಸ|ದ|ೆ
ಆಗಮಿಸಿದ	V;3;SG;MASC;PST	ಆಗಮಿಸ|ಿ|ದ
ಆಗಮಿಸಿದರು	V;3;PL;FEM;PST	ಆಗಮ|ಿ|ಸ|ಿದರ|ು
ಆಗುವನು	V;3;SG;MASC;FUT	ಆಗ|ು|ವ|ನ|ು
ಆದುವು	V;3;PL;NEUT;PST	ಆ|ದ|ು|ವ|ು
ಆಗುತ್ತಾರೆ	V;3;PL;FEM;PRS	ಆಗ|ು|ತ್ತ|ಾ|ರ|ೆ
ಆಗುತ್ತದೆ	V;3;SG;NEUT;PRS	ಆಗ|ು|ತ್ತ|ದೆ
ಆಗುವ	V.PTCP;FUT;LGSPEC1	ಆಗು|ವ
ಆಗುವುದು	V;3;SG;NEUT;FUT	ಆಗ|ು|ವ|ುದು
ಆಗುತ್ತ	V.PTCP;PRS	ಆಗ|ು|ತ್|ತ
ಆಗುತ್ತಾ	V.PTCP;PRS	ಆಗ|ು|ತ್ತ|ಾ
ಆಗುವರು	V;3;PL;FEM;FUT	ಆಗ|ು|ವ|ರ|ು
ಆಗುವೆ	V;1;SG;IMP	ಆಗ|ು|ವ|ೆ
ಆಗುತ್ತೇನೆ	V;1;SG;PRS	ಆಗು|ತ್ತ|ೇ|ನ|ೆ
ಆಗದ	V.PTCP;NEG;LGSPEC1	ಆ|ಗ|ದ
ಆದಳು	V;3;SG;FEM;PST	ಆ|ದ|ಳ|ು
ಆಗಿರಿ	V;2;PL;IMP	ಆಗ|ಿ|ರ|ಿ
ಆಗದೆ	V.PTCP;NEG	ಆಗ|ದ|ೆ
ಆದೆನು	V;1;SG;PST	ಆ|ದ|ೆ|ನ|ು
ಆಗುತ್ತೀರಿ	V;2;PL;PRS	ಆಗ|ು|ತ್ತ|ೀ|ರ|ಿ
ಆದ	V.PTCP;PST;LGSPEC1	ಆ|ದ
ಆಗಲಿ	V;NFIN;OPT	ಆಗ|ಲಿ
ಆಯಿತು	V;3;SG;NEUT;PST	ಆ|ಯ|ಿತು
ಆಗುತ್ತಾನೆ	V;3;SG;MASC;PRS	ಆಗ|ು|ತ್ತ|ಾ|ನ|ೆ
ಆದರು	V;3;PL;FEM;PST	ಆ|ದ|ರ|ು
ಆಗೋಣ	V;1;PL;IMP	ಆಗ|ೋಣ
ಆದರೆ	V;NFIN;COND	ಆ|ದ|ರೆ
ಆಗುತ್ತವೆ	V;3;PL;NEUT;PRS	ಆಗ|ು|ತ್|ತ|ವ|ೆ
ಆಗಿ	V.PTCP;PST	ಆಗ|ಿ
ಆದನು	V;3;SG;MASC;PST	ಆ|ದ|ನ|ು
ಆಗುವುವು	V;3;PL;NEUT;FUT	ಆಗ|ು|ವ|ು|ವ|ು
ಆಗದು	V;3;SG;NEUT	ಆ|ಗ|ದ|ು
ಆದಿಯಿಂದ	N;SG;INS	ಆದ|ಿ|ಯ|ಿ|ಂದ
ಆಯ್ಕೆಯ	N;SG;GEN	ಆಯ್ಕ|ೆ|ಯ
ಆಯ್ಕೆಯು	N;SG;NOM	ಆ|ಯ್|ಕೆ|ಯ|ು
ಇತಿಹಾಸವನ್ನು	N;SG;ACC	ಇತಿಹಾಸ|ವ|ನ್ನು
ಇತಿಹಾಸದ	N;SG;GEN	ಇತಿಹಾಸ|ದ
ಇತಿಹಾಸವು	N;SG;NOM	ಇತಿಹಾಸ|ವ|ು
ಈಜಲು	V;NFIN	ಈಜ|ಲ|ು
ಈಜುವುದು	V;3;SG;NEUT;FUT	ಈಜ|ು|ವ|ು|ದ|ು
ಈಜುತ್ತಾ	V.PTCP;PRS	ಈಜ|ು|ತ್ತ|ಾ
ಉಗುರುಗಳ	N;PL;GEN	ಉಗುರು|ಗ|ಳ
ಉಪಯೋಗಗಳ	N;PL;GEN	ಉಪಯೋಗ|ಗ|ಳ
ಉಪಯೋಗವನ್ನು	N;SG;ACC	ಉಪಯೋಗ|ವ|ನ್ನು
ಉಪಯೋಗಗಳನ್ನು	N;PL;ACC	ಉಪಯೋಗ|ಗ|ಳ|ನ್ನು
ಉಪಯೋಗದ	N;SG;GEN	ಉಪಯೋಗ|ದ
ಉಪಯೋಗಕ್ಕೆ	N;SG;DAT	ಉಪಯೋಗ|ಕ್ಕೆ
ಉಪಯೋಗಿಸುವ	V.PTCP;FUT;LGSPEC1	ಉಪಯೋಗ|ಿ|ಸ|ು|ವ
ಉಪಯೋಗಿಸಲು	V;NFIN	ಉಪಯೋಗಿ|ಸ|ಲ|ು
ಉಪಯೋಗಿಸುತ್ತಾರೆ	V;3;PL;FEM;PRS	ಉಪಯೋಗ|ಿಸ|ು|ತ್ತಾರೆ
ಉಪಯೋಗಿಸುವುದು	V;3;SG;NEUT;FUT	ಉಪಯೋಗ|ಿ|ಸ|ು|ವುದು
ಉಪಯೋಗಿಸುತ್ತ	V.PTCP;PRS	ಉಪಯೋಗ|ಿ|ಸ|ು|ತ್ತ
ಉಪಯೋಗಿಸಿದ	V;3;SG;MASC;PST	ಉಪಯೋಗಿಸ|ಿ|ದ
ಉಪಯೋಗಿಸುತ್ತೇವೆ	V;1;PL;PRS	ಉಪಯೋಗ|ಿಸ|ು|ತ್ತೇವೆ
ಉಪಯೋಗಿಸಿ	V.PTCP;PST	ಉಪಯೋಗಿಸ|ಿ
ಉಸಿರಾಟಗಳ	N;PL;GEN	ಉಸಿರಾಟ|ಗ|ಳ
ಉಸಿರಾಟದಿಂದ	N;SG;INS	ಉಸಿರಾಟ|ದ|ಿ|ಂದ
ಉಸಿರಾಟವನ್ನು	N;SG;ACC	ಉಸಿರಾಟ|ವ|ನ್ನು
ಉಸಿರಾಟದ	N;SG;GEN	ಉಸಿರಾಟ|ದ
ಉಸಿರಾಟಕ್ಕೆ	N;SG;DAT	ಉಸಿರಾಟ|ಕ್ಕೆ
ಎಣ್ಣೆಯಿಂದ	N;SG;INS	ಎಣ್ಣ|ೆ|ಯ|ಿ|ಂದ
ಎಣ್ಣೆಯ	N;SG;GEN	ಎಣ್ಣ|ೆ|ಯ
ಎಲೆಗಳು	N;PL;NOM	ಎಲೆ|ಗಳು
ಎಲೆಗಳಿಂದ	N;PL;INS	ಎಲೆ|ಗಳ|ಿ|ಂದ
ಎಲೆಗಳ	N;PL;GEN	ಎಲೆ|ಗ|ಳ
ಎಲೆಗಳನ್ನು	N;PL;ACC	ಎಲೆ|ಗ|ಳ|ನ್ನು
ಎಲೆಯ	N;SG;GEN	ಎಲ|ೆ|ಯ
ಎಲೆಯು	N;SG;NOM	ಎಲ|ೆ|ಯ|ು
ಓಡುವ	V.PTCP;FUT;LGSPEC1	ಓಡ|ು|ವ
ಓಡಲು	V;NFIN	ಓಡ|ಲ|ು
ಓಡುತ್ತದೆ	V;3;SG;NEUT;PRS	ಓಡ|ು|ತ್|ತ|ದ|ೆ
ಓಡುವುದು	V;3;SG;NEUT;FUT	ಓಡ|ು|ವ|ು|ದ|ು
ಓಡುತ್ತಾ	V.PTCP;PRS	ಓಡ|ು|ತ್ತ|ಾ
ಓಡಲಿ	V;NFIN;OPT	ಓಡ|ಲ|ಿ
ಓಡಿದರೆ	V;NFIN;COND	ಓಡ|ಿ|ದ|ರ|ೆ
ಓಡಿ	V.PTCP;PST	ಓಡ|ಿ
ಓಡಿದನು	V;3;SG;MASC;PST	ಓಡ|ಿ|ದ|ನ|ು
ಓದುವನು	V;3;SG;MASC;FUT	ಓದ|ು|ವ|ನ|ು
ಓದುವ	V.PTCP;FUT;LGSPEC1	ಓದ|ು|ವ
ಓದಲು	V;NFIN	ಓದ|ಲ|ು
ಓದುವುದು	V;3;SG;NEUT;FUT	ಓದ|ು|ವ|ು|ದ|ು
ಓದುತ್ತಾ	V.PTCP;PRS	ಓದ|ು|ತ್ತ|ಾ
ಓದಿ	V.PTCP;PST	ಓದ|ಿ
ಕಣ್ಣುಗಳು	N;PL;NOM	ಕಣ್ಣು|ಗಳು
ಕಣ್ಣುಗಳಿಂದ	N;PL;INS	ಕಣ್ಣು|ಗಳ|ಿ|ಂದ
ಕಣ್ಣುಗಳ	N;PL;GEN	ಕಣ್ಣು|ಗ|ಳ
ಕಣ್ಣಿನಿಂದ	N;SG;INS	ಕಣ್ಣ|ಿ|ನ|ಿ|ಂದ
ಕಣ್ಣನ್ನು	N;SG;ACC	ಕಣ್|ಣ|ನ್ನು
ಕಣ್ಣುಗಳನ್ನು	N;PL;ACC	ಕಣ್ಣು|ಗ|ಳ|ನ್ನು
ಕಣ್ಣಿನ	N;SG;GEN	ಕಣ್ಣ|ಿ|ನ
ಕಣ್ಣುಗಳಿಗೆ	N;PL;DAT	ಕಣ್ಣು|ಗಳ|ಿ|ಗೆ
ಕಣ್ಣಿಗೆ	N;SG;DAT	ಕಣ್ಣ|ಿಗೆ
ಕನಸನ್ನು	N;SG;ACC	ಕನಸ|ನ್ನು
ಕನಸಿನ	N;SG;GEN	ಕನಸ|ಿ|ನ
ಕರೆದ	V;3;SG;MASC;PST	ಕರ|ೆ|ದ
ಕರೆದರೆ	V;NFIN;COND	ಕರೆ|ದ|ರ|ೆ
ಕರೆದೆ	V;2;SG;PST	ಕರ|ೆ|ದ|ೆ
ಕರೆಯಲು	V;NFIN	ಕರೆ|ಯ|ಲ|ು
ಕರೆಯುತ್ತದೆ	V;3;SG;NEUT;PRS	ಕರ|ೆ|ಯ|ು|ತ್|ತ|ದ|ೆ
ಕರೆದರು	V;3;PL;FEM;PST	ಕರ|ೆ|ದ|ರ|ು
ಕರೆಯನ್ನು	N;SG;ACC	ಕರ|ೆ|ಯ|ನ್ನು
ಕರೆಯ	V;3;SG;MASC	ಕರ|ೆ|ಯ
ಕರೆಗಳನ್ನು	N;PL;ACC	ಕರೆ|ಗ|ಳ|ನ್ನು
ಕರೆಗೆ	N;SG;DAT	ಕರೆ|ಗೆ
ಕರೆಯುತ್ತವೆ	V;3;PL;NEUT;PRS	ಕರ|ೆ|ಯ|ು|ತ್|ತ|ವ|ೆ
ಕರೆ	V;2;SG;IMP	ಕರ|ೆ
ಕರೆಯದೆ	V.PTCP;NEG	ಕರ|ೆ|ಯ|ದ|ೆ
ಕರೆಯುತ್ತಾರೆ	V;3;PL;FEM;PRS	ಕರೆ|ಯ|ು|ತ್ತ|ಾ|ರ|ೆ
ಕರೆಯುವುದು	V;3;SG;NEUT;FUT	ಕರ|ೆ|ಯ|ು|ವ|ು|ದ|ು
ಕರೆಗಳು	N;PL;NOM	ಕರೆ|ಗಳು
ಕರೆದು	V.PTCP;PST	ಕರ|ೆ|ದ|ು
ಕರೆಗಳ	N;PL;GEN	ಕರೆ|ಗ|ಳ
ಕರೆಯುತ್ತೇವೆ	V;1;PL;PRS	ಕರ|ೆ|ಯ|ು|ತ್ತ|ೇ|ವ|ೆ
ಕಲ್ಲುಗಳು	N;PL;NOM	ಕಲ್ಲು|ಗಳು
ಕಲ್ಲುಗಳಿಂದ	N;PL;INS	ಕಲ್ಲು|ಗಳ|ಿ|ಂದ
ಕಲ್ಲುಗಳ	N;PL;GEN	ಕಲ್ಲು|ಗ|ಳ
ಕಲ್ಲಿನಿಂದ	N;SG;INS	ಕಲ್ಲ|ಿನ|ಿ|ಂದ
ಕಲ್ಲುಗಳನ್ನು	N;PL;ACC	ಕಲ್ಲು|ಗ|ಳ|ನ್ನು
ಕಲ್ಲಿನ	N;SG;GEN	ಕಲ್ಲ|ಿ|ನ
ಕಲ್ಲಿಗೆ	N;SG;DAT	ಕಲ್ಲ|ಿಗೆ
ಕಾಡುಗಳಿಂದ	N;PL;INS	ಕಾಡು|ಗಳ|ಿ|ಂದ
ಕಾಡಿನಿಂದ	N;SG;INS	ಕಾಡ|ಿ|ನ|ಿ|ಂದ
ಕಾಡನ್ನು	N;SG;ACC	ಕಾ|ಡ|ನ್ನು
ಕಾಡಿನ	N;SG;GEN	ಕಾಡ|ಿ|ನ
ಕಾಡಿಗೆ	N;SG;DAT	ಕಾಡ|ಿಗೆ
ಕಾಡುಗಳು	N;PL;NOM	ಕಾಡು|ಗಳು
ಕಾಡುಗಳ	N;PL;GEN	ಕಾಡು|ಗ|ಳ
ಕಾನನದ	N;SG;GEN	ಕಾನನ|ದ
ಕಾಪಾಡುವ	V.PTCP;FUT;LGSPEC1	ಕಾಪಾಡ|ು|ವ
ಕಾಪಾಡಲು	V;NFIN	ಕಾಪಾ|ಡ|ಲ|ು
ಕಾಪಾಡುತ್ತದೆ	V;3;SG;NEUT;PRS	ಕಾಪಾಡ|ು|ತ್|ತ|ದ|ೆ
ಕಾಪಾಡುವುದು	V;3;SG;NEUT;FUT	ಕಾಪಾಡ|ು|ವ|ು|ದ|ು
ಕಾಪಾಡದೆ	V.PTCP;NEG	ಕಾಪಾ|ಡ|ದ|ೆ
ಕಾಪಾಡಿದ	V;3;SG;MASC;PST	ಕಾಪಾಡ|ಿ|ದ
ಕಾಪಾಡಲಿ	V;NFIN;OPT	ಕಾ|ಪ|ಾಡ|ಲ|ಿ
ಕಾಲುಗಳು	N;PL;NOM	ಕಾಲು|ಗಳು
ಕಾಲುಗಳ	N;PL;GEN	ಕಾಲು|ಗ|ಳ
ಕಾಲಿನಿಂದ	N;SG;INS	ಕಾಲ|ಿ|ನ|ಿ|ಂದ
ಕಾಲನ್ನು	N;SG;ACC	ಕಾಲ|ನ್ನು
ಕಾಲಿನ	N;SG;GEN	ಕಾಲ|ಿ|ನ
ಕಾಲಿಗೆ	N;SG;DAT	ಕಾಲ|ಿಗೆ
ಕುಡಿಯುವ	V.PTCP;FUT;LGSPEC1	ಕುಡ|ಿ|ಯ|ು|ವ
ಕುಡಿಯುತ್ತಾ	V.PTCP;PRS	ಕುಡ|ಿ|ಯ|ು|ತ್ತ|ಾ
ಕುಡಿಯೋಣ	V;1;PL;IMP	ಕುಡ|ಿ|ಯ|ೋ|ಣ
ಕುಡಿದರೆ	V;NFIN;COND	ಕುಡ|ಿ|ದ|ರ|ೆ
ಕುದುರೆಗಳು	N;PL;NOM	ಕುದುರೆ|ಗಳು
ಕುದುರೆಯನ್ನು	N;SG;ACC	ಕುದುರ|ೆ|ಯ|ನ್ನು
ಕುದುರೆಗಳನ್ನು	N;PL;ACC	ಕುದುರೆ|ಗ|ಳ|ನ್ನು
ಕುದುರೆಯ	N;SG;GEN	ಕುದುರ|ೆ|ಯ
ಕುದುರೆಗೆ	N;SG;DAT	ಕುದುರೆ|ಗೆ
ಕುದುರೆಯು	N;SG;NOM	ಕುದುರ|ೆ|ಯ|ು
ಕೆಮ್ಮಿನ	N;SG;GEN	ಕೆಮ್ಮ|ಿ|ನ
ಕೆಮ್ಮಿ	V.PTCP;PST	ಕೆಮ್ಮ|ಿ
ಕೆಲಸಗಳು	N;PL;NOM	ಕೆಲಸ|ಗಳು
ಕೆಲಸಗಳ	N;PL;GEN	ಕೆಲಸ|ಗ|ಳ
ಕೆಲಸದಿಂದ	N;SG;INS	ಕೆಲಸ|ದ|ಿ|ಂದ
ಕೆಲಸವನ್ನು	N;SG;ACC	ಕೆಲಸ|ವ|ನ್ನು
ಕೆಲಸಗಳನ್ನು	N;PL;ACC	ಕೆಲಸ|ಗ|ಳ|ನ್ನು
ಕೆಲಸದ	N;SG;GEN	ಕೆಲಸ|ದ
ಕೆಲಸಗಳಿಗೆ	N;PL;DAT	ಕೆಲಸ|ಗಳ|ಿ|ಗೆ
ಕೆಲಸಕ್ಕೆ	N;SG;DAT	ಕೆಲಸ|ಕ್ಕೆ
ಕೆಲಸವು	N;SG;NOM	ಕೆಲಸ|ವ|ು
ಕೇಳುವನು	V;3;SG;MASC;FUT	ಕೇಳ|ು|ವ|ನ|ು
ಕೇಳುವ	V.PTCP;FUT;LGSPEC1	ಕೇಳ|ು|ವ
ಕೇಳಲು	V;NFIN	ಕೇ|ಳ|ಲ|ು
ಕೇಳುತ್ತಾರೆ	V;3;PL;FEM;PRS	ಕೇಳ|ು|ತ್ತ|ಾ|ರ|ೆ
ಕೇಳುವುದು	V;3;SG;NEUT;FUT	ಕೇಳ|ು|ವ|ು|ದ|ು
ಕೇಳುವರು	V;3;PL;FEM;FUT	ಕೇಳ|ು|ವ|ರ|ು
ಕೇಳುತ್ತೇನೆ	V;1;SG;PRS	ಕೇಳ|ು|ತ್ತ|ೇ|ನ|ೆ
ಕೇಳಿದಳು	V;3;SG;FEM;PST	ಕೇಳ|ಿ|ದ|ಳ|ು
ಕೇಳಿದ	V;3;SG;MASC;PST	ಕೇಳ|ಿ|ದ
ಕೇಳಲಿ	V;NFIN;OPT	ಕೇ|ಳ|ಲ|ಿ
ಕೇಳುತ್ತಾನೆ	V;3;SG;MASC;PRS	ಕೇಳ|ು|ತ್ತ|ಾ|ನ|ೆ
ಕೇಳಿದರು	V;3;PL;FEM;PST	ಕೇಳ|ಿ|ದ|ರ|ು
ಕೇಳೋಣ	V;1;PL;IMP	ಕೇಳ|ೋ|ಣ
ಕೇಳಿದರೆ	V;NFIN;COND	ಕೇಳ|ಿ|ದ|ರ|ೆ
ಕೇಳುತ್ತೇವೆ	V;1;PL;PRS	ಕೇಳ|ು|ತ್ತ|ೇ|ವ|ೆ
ಕೇಳಿ	V.PTCP;PST	ಕೇಳ|ಿ
ಕೈಗಳು	N;PL;NOM	ಕೈ|ಗಳು
ಕೈಗಳ	N;PL;GEN	ಕೈ|ಗ|ಳ
ಕೈಯಿಂದ	N;SG;INS	ಕೈ|ಯ|ಿಂದ
ಕೈಗೆ	N;SG;DAT	ಕೈ|ಗೆ
ಕೊಡುವ	V.PTCP;FUT;LGSPEC1	ಕೊಡ|ು|ವ
ಕೊಡಲು	V;NFIN	ಕೊ|ಡ|ಲ|ು
ಕೊಡುತ್ತಾರೆ	V;3;PL;FEM;PRS	ಕೊಡ|ು|ತ್ತ|ಾ|ರ|ೆ
ಕೊಡುತ್ತದೆ	V;3;SG;NEUT;PRS	ಕೊಡ|ು|ತ್|ತ|ದ|ೆ
ಕೊಡುವುದು	V;3;SG;NEUT;FUT	ಕೊಡ|ು|ವ|ು|ದ|ು
ಕೊಡುತ್ತ	V.PTCP;PRS	ಕೊಡ|ು|ತ್|ತ
ಕೊಡುವೆ	V;1;SG;FUT	ಕೊಡ|ು|ವ|ೆ
ಕೊಡುತ್ತೇನೆ	V;1;SG;PRS	ಕೊಡು|ತ್ತ|ೇ|ನ|ೆ
ಕೊಡದ	V.PTCP;NEG;LGSPEC1	ಕೊ|ಡ|ದ
ಕೊಟ್ಟಳು	V;3;SG;FEM;PST	ಕೊ|ಟ್ಟ|ಳು
ಕೊಡುತ್ತಾಳೆ	V;3;SG;FEM;PRS	ಕೊಡ|ು|ತ್ತ|ಾ|ಳ|ೆ
ಕೊಡದೆ	V.PTCP;NEG	ಕೊಡ|ದ|ೆ
ಕೊಟ್ಟೆ	V;2;SG;PST	ಕೊ|ಟ್ಟ|ೆ
ಕೊಡುತ್ತೀರಿ	V;2;PL;PRS	ಕೊಡ|ು|ತ್ತ|ೀ|ರ|ಿ
ಕೊಟ್ಟ	V;3;SG;MASC;PST	ಕೊ|ಟ್|ಟ
ಕೊಡಲಿ	V;NFIN;OPT	ಕೊ|ಡ|ಲ|ಿ
ಕೊಟ್ಟಿತು	V;3;SG;NEUT;PST	ಕೊ|ಟ್ಟ|ಿ|ತ|ು
ಕೊಡುತ್ತಾನೆ	V;3;SG;MASC;PRS	ಕೊಡ|ು|ತ್ತ|ಾ|ನ|ೆ
ಕೊಟ್ಟರು	V;3;PL;FEM;PST	ಕೊ|ಟ್|ಟ|ರ|ು
ಕೊಡೋಣ	V;1;PL;IMP	ಕೊಡ|ೋ|ಣ
ಕೊಟ್ಟರೆ	V;NFIN;COND	ಕೊ|ಟ್|ಟ|ರ|ೆ
ಕೊಡುತ್ತವೆ	V;3;PL;NEUT;PRS	ಕೊಡ|ು|ತ್|ತ|ವ|ೆ
ಕೊಡುತ್ತೇವೆ	V;1;PL;PRS	ಕೊಡ|ು|ತ್ತ|ೇ|ವ|ೆ
ಕೊಟ್ಟನು	V;3;SG;MASC;PST	ಕೊ|ಟ್|ಟ|ನ|ು
ಕೊಡುತ್ತೀ	V;2;SG;PRS	ಕೊಡು|ತ್ತ|ೀ
ಕೊಲ್ಲುವ	V.PTCP;FUT;LGSPEC1	ಕೊಲ್ಲ|ು|ವ
ಕೊಂದೆ	V;2;SG;PST	ಕೊ|ಂದ|ೆ
ಕೊಂದ	V;3;SG;MASC;PST	ಕೊ|ಂ|ದ
ಕೊಂದರೆ	V;NFIN;COND	ಕೊ|ಂ|ದ|ರ|ೆ
ಕೊಂದು	V.PTCP;PST	ಕೊ|ಂದ|ು
ಕೊಳಗಳ	N;PL;GEN	ಕೊಳ|ಗ|ಳ
ಕೊಳದಿಂದ	N;SG;INS	ಕೊಳ|ದ|ಿ|ಂದ
ಕೊಳಗಳನ್ನು	N;PL;ACC	ಕೊಳ|ಗ|ಳ|ನ್ನು
ಕೊಳದ	N;SG;GEN	ಕೊಳ|ದ
ಕೊಳಕ್ಕೆ	N;SG;DAT	ಕೊಳ|ಕ್ಕೆ
ಕೋಣೆಗಳು	N;PL;NOM	ಕೋಣೆ|ಗಳು
ಕೋಣೆಗಳನ್ನು	N;PL;ACC	ಕೋಣೆ|ಗ|ಳ|ನ್ನು
ಕೋಣೆಯ	N;SG;GEN	ಕೋಣೆ|ಯ
ಕ್ರಿಯಾಪದಗಳನ್ನು	N;PL;ACC	ಕ್ರಿಯಾಪದ|ಗ|ಳ|ನ್ನು
ಕ್ರಿಯಾಪದದ	N;SG;GEN	ಕ್ರಿಯಾಪದ|ದ
ಗಾಳಿಗಳು	N;PL;NOM	ಗಾಳಿ|ಗಳು
ಗಾಳಿಯಿಂದ	N;SG;INS	ಗಾಳ|ಿ|ಯ|ಿ|ಂದ
ಗಾಳಿಯನ್ನು	N;SG;ACC	ಗಾಳಿ|ಯ|ನ್ನು
ಗಾಳಿಯ	N;SG;GEN	ಗಾಳ|ಿ|ಯ
ಗಾಳಿಗೆ	N;SG;DAT	ಗಾಳಿ|ಗೆ
ಗಾಳಿಯು	N;SG;NOM	ಗಾಳ|ಿ|ಯ|ು
ಗಿಡಗಳು	N;PL;NOM	ಗಿಡ|ಗಳು
ಗಿಡಗಳಿಂದ	N;PL;INS	ಗಿಡ|ಗಳ|ಿ|ಂದ
ಗಿಡಗಳ	N;PL;GEN	ಗಿಡ|ಗ|ಳ
ಗಿಡದಿಂದ	N;SG;INS	ಗಿಡ|ದ|ಿ|ಂದ
ಗಿಡಗಳನ್ನು	N;PL;ACC	ಗಿಡ|ಗ|ಳ|ನ್ನು
ಗಿಡದ	N;SG;GEN	ಗಿಡ|ದ
ಗಿಡಗಳಿಗೆ	N;PL;DAT	ಗಿಡ|ಗಳ|ಿ|ಗೆ
ಗಿಡಕ್ಕೆ	N;SG;DAT	ಗಿಡ|ಕ್ಕೆ
ಗಿಡವು	N;SG;NOM	ಗಿಡ|ವ|ು
ಗುಂಪುಗಳ	N;PL;GEN	ಗುಂಪು|ಗ|ಳ
ಗುಂಪನ್ನು	N;SG;ACC	ಗುಂ|ಪ|ನ್ನು
ಗುಂಪಿನ	N;SG;GEN	ಗುಂಪ|ಿ|ನ
ಗುಂಪಿಗೆ	N;SG;DAT	ಗುಂಪ|ಿಗೆ
ಗೆಲ್ಲಲು	V;NFIN	ಗೆ|ಲ್|ಲ|ಲ|ು
ಗೆದ್ದಿರಿ	V;2;PL;PST	ಗೆ|ದ್ದ|ಿ|ರ|ಿ
ಗೆದ್ದೆ	V;2;SG;PST	ಗೆ|ದ್ದ|ೆ
ಗೆದ್ದ	V;3;SG;MASC;PST	ಗೆ|ದ್|ದ
ಗೆದ್ದಿತು	V;3;SG;NEUT;PST	ಗೆ|ದ್ದ|ಿ|ತ|ು
ಗೆಲ್ಲುತ್ತೇವೆ	V;1;PL;PRS	ಗೆಲ್ಲ|ು|ತ್ತ|ೇ|ವ|ೆ
ಗೆದ್ದು	V.PTCP;PST	ಗೆ|ದ್ದ|ು
ಗ್ರಹಗಳು	N;PL;NOM	ಗ್ರಹ|ಗಳು
ಗ್ರಹಗಳ	N;PL;GEN	ಗ್ರಹ|ಗ|ಳ
ಗ್ರಹಗಳನ್ನು	N;PL;ACC	ಗ್ರಹ|ಗ|ಳ|ನ್ನು
ಚಕ್ರಗಳು	N;PL;NOM	ಚಕ್ರ|ಗಳು
ಚಕ್ರವನ್ನು	N;SG;ACC	ಚಕ್ರ|ವ|ನ್ನು
ಚಹಾದ	N;SG;GEN	ಚಹಾ|ದ
ಚಹಾಕ್ಕೆ	N;SG;DAT	ಚಹಾ|ಕ್ಕೆ
ಜಲಪಾತಗಳು	N;PL;NOM	ಜಲಪಾತ|ಗಳು
ಜಲಪಾತಗಳ	N;PL;GEN	ಜಲಪಾತ|ಗ|ಳ
ಜಲಪಾತದಿಂದ	N;SG;INS	ಜಲಪಾತ|ದ|ಿ|ಂದ
ಜಲಪಾತವನ್ನು	N;SG;ACC	ಜಲಪಾತ|ವ|ನ್ನು
ಜಲಪಾತದ	N;SG;GEN	ಜಲಪಾತ|ದ
ಜಲಪಾತಕ್ಕೆ	N;SG;DAT	ಜಲಪಾತ|ಕ್ಕೆ
ಜಲಪಾತವು	N;SG;NOM	ಜಲಪಾತ|ವ|ು
ತಂದೆಯ	N;SG;GEN	ತಂದೆ|ಯ
ತಂದೆಗೆ	N;SG;DAT	ತಂದೆ|ಗೆ
ತಡೆಯಲು	V;NFIN	ತಡ|ೆ|ಯ|ಲ|ು
ತಡೆಯನ್ನು	N;SG;ACC	ತಡೆ|ಯ|ನ್ನು
ತಡೆಯುತ್ತಾ	V.PTCP;PRS	ತಡ|ೆ|ಯ|ು|ತ್ತ|ಾ
ತಲೆಯಿಂದ	N;SG;INS	ತಲ|ೆ|ಯ|ಿ|ಂದ
ತಲೆಯನ್ನು	N;SG;ACC	ತಲೆ|ಯ|ನ್ನು
ತಲೆಯ	N;SG;GEN	ತಲೆ|ಯ
ತಲೆಗೆ	N;SG;DAT	ತಲೆ|ಗೆ
ತಾಯಿಯನ್ನು	N;SG;ACC	ತಾಯ|ಿ|ಯ|ನ್ನು
ತಾಯಿಯ	N;SG;GEN	ತಾಯ|ಿ|ಯ
ತಾಯಿಗೆ	N;SG;DAT	ತಾಯಿ|ಗೆ
ತುಟಿಯ	N;SG;GEN	ತುಟ|ಿ|ಯ
ತೊಡೆಯ	N;SG;GEN	ತೊಡೆ|ಯ
ತೊಳೆಯಲು	V;NFIN	ತೊಳ|ೆ|ಯ|ಲ|ು
ತೊಳೆದ	V;3;SG;MASC;PST	ತೊಳ|ೆ|ದ
ತೊಳೆದು	V.PTCP;PST	ತೊಳ|ೆ|ದ|ು
ದಾಟಲು	V;NFIN	ದಾ|ಟ|ಲ|ು
ದಾಟಿದ	V;3;SG;MASC;PST	ದಾಟ|ಿ|ದ
ದಾಟಿ	V.PTCP;PST	ದಾಟ|ಿ
ದೇವರು	N;PL;NOM	ದೇವ|ರ|ು
ದೇವರಿಂದ	N;PL;INS	ದೇವ|ರ|ಿ|ಂದ
ದೇವರ	N;PL;GEN	ದೇವ|ರ
ದೇವರನ್ನು	N;PL;ACC	ದೇವ|ರ|ನ್ನು
ದೇವನ	N;SG;GEN	ದೇವ|ನ
ದೇವರಿಗೆ	N;PL;DAT	ದೇವರ|ಿಗೆ
ದೇವನಿಗೆ	N;SG;DAT	ದೇವ|ನ|ಿ|ಗೆ
ನಡೆಯುವ	V.PTCP;FUT;LGSPEC1	ನಡ|ೆ|ಯ|ು|ವ
ನಡೆಯಲು	V;NFIN	ನಡ|ೆ|ಯ|ಲ|ು
ನಡೆಯುತ್ತಾರೆ	V;3;PL;FEM;PRS	ನಡ|ೆ|ಯ|ು|ತ್ತ|ಾ|ರ|ೆ
ನಡೆಯುತ್ತದೆ	V;3;SG;NEUT;PRS	ನಡ|ೆ|ಯ|ು|ತ್|ತ|ದ|ೆ
ನಡೆಯುವುದು	V;3;SG;NEUT;FUT	ನಡ|ೆ|ಯ|ು|ವ|ು|ದ|ು
ನಡೆಯುತ್ತ	V.PTCP;PRS	ನಡ|ೆ|ಯ|ು|ತ್|ತ
ನಡೆಯುತ್ತಾ	V.PTCP;PRS	ನಡ|ೆ|ಯ|ು|ತ್ತ|ಾ
ನಡೆಯಿರಿ	V;2;PL;IMP	ನಡ|ೆ|ಯ|ಿ|ರ|ಿ
ನಡೆದ	V;3;SG;MASC;PST	ನಡ|ೆ|ದ
ನಡೆಯಿತು	V;3;SG;NEUT;PST	ನಡ|ೆ|ಯ|ಿ|ತ|ು
ನಡೆದರೆ	V;NFIN;COND	ನಡ|ೆ|ದ|ರ|ೆ
ನಡೆಯುತ್ತವೆ	V;3;PL;NEUT;PRS	ನಡ|ೆ|ಯ|ು|ತ್|ತ|ವ|ೆ
ನಡೆದು	V.PTCP;PST	ನಡೆ|ದ|ು
ನಡೆಯುವುವು	V;3;PL;NEUT;FUT	ನಡ|ೆ|ಯ|ು|ವ|ು|ವ|ು
ನಡೆಯದು	V;3;SG;NEUT	ನಡ|ೆ|ಯ|ದ|ು
ನದಿಗಳು	N;PL;NOM	ನದಿ|ಗಳು
ನದಿಗಳಿಂದ	N;PL;INS	ನದಿ|ಗಳ|ಿ|ಂದ
ನದಿಗಳ	N;PL;GEN	ನದಿ|ಗ|ಳ
ನದಿಯಿಂದ	N;SG;INS	ನದ|ಿ|ಯ|ಿ|ಂದ
ನದಿಯನ್ನು	N;SG;ACC	ನದಿ|ಯ|ನ್ನು
ನದಿಗಳನ್ನು	N;PL;ACC	ನದಿ|ಗ|ಳ|ನ್ನು
ನದಿಯ	N;SG;GEN	ನದಿ|ಯ
ನದಿಗೆ	N;SG;DAT	ನದಿ|ಗೆ
ನದಿಯು	N;SG;NOM	ನದ|ಿ|ಯ|ು
ನಾಯಿಗಳು	N;PL;NOM	ನಾಯಿ|ಗಳು
ನಾಯಿಗಳ	N;PL;GEN	ನಾಯಿ|ಗ|ಳ
ನಾಯಿಯನ್ನು	N;SG;ACC	ನಾಯ|ಿ|ಯ|ನ್ನು
ನಾಯಿಯ	N;SG;GEN	ನಾಯ|ಿ|ಯ
ನಾಯಿಗಳಿಗೆ	N;PL;DAT	ನಾಯಿ|ಗಳ|ಿ|ಗೆ
ನಾಯಿಗೆ	N;SG;DAT	ನಾಯಿ|ಗೆ
ನಿಯಮಗಳು	N;PL;NOM	ನಿಯಮ|ಗಳು
ನಿಯಮಗಳ	N;PL;GEN	ನಿಯಮ|ಗ|ಳ
ನಿಯಮವನ್ನು	N;SG;ACC	ನಿಯಮ|ವ|ನ್ನು
ನಿಯಮಗಳನ್ನು	N;PL;ACC	ನಿಯಮ|ಗ|ಳ|ನ್ನು
ನಿಯಮದ	N;SG;GEN	ನಿಯಮ|ದ
ನಿಯಮಗಳಿಗೆ	N;PL;DAT	ನಿಯಮ|ಗಳ|ಿ|ಗೆ
ನಿಯಮಕ್ಕೆ	N;SG;DAT	ನಿಯಮ|ಕ್ಕೆ
ನಿಯಮವು	N;SG;NOM	ನಿಯಮ|ವ|ು
ನೀರಿನಿಂದ	N;SG;INS	ನೀರ|ಿನ|ಿ|ಂದ
ನೀರನ್ನು	N;SG;ACC	ನೀರ|ನ್ನು
ನೀರಿನ	N;SG;GEN	ನೀರ|ಿ|ನ
ನೀರಿಗೆ	N;SG;DAT	ನೀರ|ಿಗೆ
ನೋಡುವ	V.PTCP;FUT;LGSPEC1	ನೋಡ|ು|ವ
ನೋಡಲು	V;NFIN	ನೋಡ|ಲ|ು
ನೋಡ	V;3;SG;MASC	ನೋ|ಡ
ನೋಡುವುದು	V;3;SG;NEUT;FUT	ನೋಡ|ು|ವ|ು|ದ|ು
ನೋಡುತ್ತ	V.PTCP;PRS	ನೋಡ|ು|ತ್|ತ
ನೋಡುತ್ತಾ	V.PTCP;PRS	ನೋಡ|ು|ತ್ತ|ಾ
ನೋಡುತ್ತೇನೆ	V;1;SG;PRS	ನೋಡ|ು|ತ್ತ|ೇ|ನ|ೆ
ನೋಡದೆ	V.PTCP;NEG	ನೋ|ಡ|ದ|ೆ
ನೋಡಿದೆ	V;2;SG;PST	ನೋಡ|ಿ|ದ|ೆ
ನೋಡುತ್ತೀರಿ	V;2;PL;PRS	ನೋಡ|ು|ತ್ತ|ೀರ|ಿ
ನೋಡಿದ	V;3;SG;MASC;PST	ನೋಡ|ಿ|ದ
ನೋಡಲಿ	V;NFIN;OPT	ನೋ|ಡ|ಲ|ಿ
ನೋಡಿತು	V;3;SG;NEUT;PST	ನೋಡ|ಿ|ತ|ು
ನೋಡಿದರು	V;3;PL;FEM;PST	ನೋಡ|ಿ|ದ|ರ|ು
ನೋಡೋಣ	V;1;PL;IMP	ನೋಡ|ೋ|ಣ
ನೋಡಲಿಕ್ಕೆ	V;NFIN;LGSPEC2	ನೋಡ|ಲಿ|ಕ್ಕೆ
ನೋಡಿದರೆ	V;NFIN;COND	ನೋಡ|ಿ|ದ|ರ|ೆ
ನೋಡಿದೆವು	V;1;PL;PST	ನೋಡ|ಿ|ದ|ೆ|ವ|ು
ನೋಡಿ	V.PTCP;PST	ನೋಡ|ಿ
ನೋಡಿದನು	V;3;SG;MASC;PST	ನೋಡ|ಿ|ದ|ನ|ು
ಪರ್ವತಗಳು	N;PL;NOM	ಪರ್ವತ|ಗಳು
ಪರ್ವತಗಳಿಂದ	N;PL;INS	ಪರ್ವತ|ಗಳ|ಿ|ಂದ
ಪರ್ವತಗಳ	N;PL;GEN	ಪರ್ವತ|ಗ|ಳ
ಪರ್ವತದಿಂದ	N;SG;INS	ಪರ್ವತ|ದ|ಿ|ಂದ
ಪರ್ವತವನ್ನು	N;SG;ACC	ಪರ್ವತ|ವ|ನ್ನು
ಪರ್ವತಗಳನ್ನು	N;PL;ACC	ಪರ್ವತ|ಗ|ಳ|ನ್ನು
ಪರ್ವತದ	N;SG;GEN	ಪರ್ವತ|ದ
ಪುಸ್ತಕಗಳು	N;PL;NOM	ಪುಸ್ತಕ|ಗಳು
ಪುಸ್ತಕಗಳಿಂದ	N;PL;INS	ಪುಸ್ತಕ|ಗಳ|ಿ|ಂದ
ಪುಸ್ತಕಗಳ	N;PL;GEN	ಪುಸ್ತಕ|ಗ|ಳ
ಪುಸ್ತಕದಿಂದ	N;SG;INS	ಪುಸ್ತಕ|ದ|ಿ|ಂದ
ಪುಸ್ತಕವನ್ನು	N;SG;ACC	ಪುಸ್ತಕ|ವ|ನ್ನು
ಪುಸ್ತಕಗಳನ್ನು	N;PL;ACC	ಪುಸ್ತಕ|ಗ|ಳ|ನ್ನು
ಪುಸ್ತಕದ	N;SG;GEN	ಪುಸ್ತಕ|ದ
ಪುಸ್ತಕಕ್ಕೆ	N;SG;DAT	ಪುಸ್ತಕ|ಕ್ಕೆ
ಪುಸ್ತಕವು	N;SG;NOM	ಪುಸ್ತಕ|ವ|ು
ಪ್ರಯತ್ನಗಳ	N;PL;GEN	ಪ್ರಯತ್ನ|ಗ|ಳ
ಪ್ರಯತ್ನವನ್ನು	N;SG;ACC	ಪ್ರಯತ್ನ|ವ|ನ್ನು
ಪ್ರಯತ್ನಕ್ಕೆ	N;SG;DAT	ಪ್ರಯತ್ನ|ಕ್ಕೆ
ಪ್ರಯತ್ನಿಸುತ್ತಾರೆ	V;3;PL;FEM;PRS	ಪ್ರಯತ್ನ|ಿ|ಸ|ು|ತ್ತಾರೆ
ಪ್ರಯತ್ನಿಸುತ್ತಾ	V.PTCP;PRS	ಪ್ರಯತ್ನ|ಿ|ಸ|ು|ತ್ತಾ
ಪ್ರಯತ್ನಿಸಿದ	V;3;SG;MASC;PST	ಪ್ರಯತ್ನ|ಿ|ಸ|ಿ|ದ
ಪ್ರಯತ್ನಿಸಿತು	V;3;SG;NEUT;PST	ಪ್ರಯತ್ನ|ಿ|ಸ|ಿತ|ು
ಪ್ರಯತ್ನಿಸೋಣ	V;1;PL;IMP	ಪ್ರಯತ್ನ|ಿ|ಸ|ೋಣ
ಪ್ರಯತ್ನಿಸಿದರೆ	V;NFIN;COND	ಪ್ರಯತ್ನಿಸ|ಿ|ದ|ರ|ೆ
ಪ್ರಯತ್ನಿಸಿದನು	V;3;SG;MASC;PST	ಪ್ರಯತ್ನ|ಿ|ಸ|ಿದನ|ು
ಬಯಕೆಗಳು	N;PL;NOM	ಬಯಕೆ|ಗಳು
ಬಯಸುತ್ತಾರೆ	V;3;PL;FEM;PRS	ಬಯಸ|ು|ತ್ತ|ಾ|ರ|ೆ
ಬಯಸುವರು	V;3;PL;FEM;FUT	ಬಯಸ|ು|ವ|ರ|ು
ಬಯಸಿದರೆ	V;NFIN;COND	ಬಯಸ|ಿ|ದ|ರ|ೆ
ಬಯಸಿದನು	V;3;SG;MASC;PST	ಬಯ|ಸ|ಿದನ|ು
ಬೆಂಕಿಯನ್ನು	N;SG;ACC	ಬೆಂಕ|ಿ|ಯ|ನ್ನು
ಬೆಂಕಿಯ	N;SG;GEN	ಬೆಂಕ|ಿ|ಯ
ಬೆಂಕಿಗೆ	N;SG;DAT	ಬೆಂಕ|ಿ|ಗೆ
ಬೆಟ್ಟಗಳು	N;PL;NOM	ಬೆಟ್ಟ|ಗಳು
ಬೆಟ್ಟಗಳಿಂದ	N;PL;INS	ಬೆಟ್ಟ|ಗಳ|ಿ|ಂದ
ಬೆಟ್ಟಗಳ	N;PL;GEN	ಬೆಟ್ಟ|ಗ|ಳ
ಬೆಟ್ಟದಿಂದ	N;SG;INS	ಬೆಟ್ಟ|ದ|ಿ|ಂದ
ಬೆಟ್ಟವನ್ನು	N;SG;ACC	ಬೆಟ್ಟ|ವ|ನ್ನು
ಬೆಟ್ಟದ	N;SG;GEN	ಬೆಟ್ಟ|ದ
ಬೆಟ್ಟಕ್ಕೆ	N;SG;DAT	ಬೆಟ್ಟ|ಕ್ಕೆ
ಬೆವರಿನ	N;SG;GEN	ಬೆವರ|ಿ|ನ
ಭಕ್ತಿಯಿಂದ	N;SG;INS	ಭಕ್ತ|ಿ|ಯ|ಿ|ಂದ
ಭಕ್ತಿಯನ್ನು	N;SG;ACC	ಭಕ್ತ|ಿ|ಯ|ನ್ನು
ಭಕ್ತಿಗೆ	N;SG;DAT	ಭಕ್ತಿ|ಗೆ
ಮಕ್ಕಳ	N;PL;GEN	ಮಕ್ಕ|ಳ
ಮಕ್ಕಳನ್ನು	N;PL;ACC	ಮಕ್ಕಳ|ನ್ನು
ಮಗನ	N;SG;GEN	ಮ|ಗ|ನ
ಮಕ್ಕಳಿಗೆ	N;PL;DAT	ಮಕ್ಕಳ|ಿಗೆ
ಮಗನನ್ನು	N;SG;ACC	ಮಗ|ನ|ನ|್|ನು
ಮಗನಿಗೆ	N;SG;DAT	ಮಗ|ನ|ಿ|ಗೆ
ಮಕ್ಕಳಿಂದ	N;PL;INS	ಮಕ್ಕಳ|ಿ|ಂದ
ಮಗುವಿನ	N;SG;GEN	ಮಗ|ು|ವ|ಿ|ನ
ಮಗುವನ್ನು	N;SG;ACC	ಮಗು|ವ|ನ್ನು
ಮಗುವಿಗೆ	N;SG;DAT	ಮಗು|ವ|ಿಗೆ
ಮನೆಗಳು	N;PL;NOM	ಮನೆ|ಗಳು
ಮನೆಯಿಂದ	N;SG;INS	ಮನೆ|ಯ|ಿ|ಂದ
ಮನೆಯನ್ನು	N;SG;ACC	ಮನ|ೆ|ಯ|ನ್ನು
ಮನೆಗಳನ್ನು	N;PL;ACC	ಮನೆ|ಗ|ಳ|ನ್ನು
ಮನೆಯ	N;SG;GEN	ಮನೆ|ಯ
ಮನೆಗೆ	N;SG;DAT	ಮನೆ|ಗೆ
ಮನೆಯು	N;SG;NOM	ಮನ|ೆ|ಯ|ು
ಮರಗಳು	N;PL;NOM	ಮರ|ಗಳು
ಮರಗಳಿಂದ	N;PL;INS	ಮರ|ಗಳ|ಿ|ಂದ
ಮರಗಳ	N;PL;GEN	ಮರ|ಗ|ಳ
ಮರದಿಂದ	N;SG;INS	ಮರ|ದ|ಿ|ಂದ
ಮರವನ್ನು	N;SG;ACC	ಮರ|ವ|ನ್ನು
ಮರಗಳನ್ನು	N;PL;ACC	ಮರ|ಗ|ಳ|ನ್ನು
ಮರದ	N;SG;GEN	ಮರ|ದ
ಮರಗಳಿಗೆ	N;PL;DAT	ಮರ|ಗಳ|ಿ|ಗೆ
ಮರಕ್ಕೆ	N;SG;DAT	ಮರ|ಕ್ಕೆ
ಮರವು	N;SG;NOM	ಮರ|ವ|ು
ಮಳೆಯ	N;SG;GEN	ಮಳೆ|ಯ
ಮಳೆಯು	N;SG;NOM	ಮಳ|ೆ|ಯ|ು
ಮಾಡುವ	V.PTCP;FUT;LGSPEC1	ಮಾಡು|ವ
ಮಾಡಲು	V;NFIN	ಮಾಡ|ಲ|ು
ಮಾಡುತ್ತಾರೆ	V;3;PL;FEM;PRS	ಮಾಡ|ು|ತ್ತ|ಾ|ರ|ೆ
ಮಾಡುತ್ತದೆ	V;3;SG;NEUT;PRS	ಮಾಡ|ು|ತ್|ತ|ದ|ೆ
ಮಾಡುವುದು	V;3;SG;NEUT;FUT	ಮಾಡ|ು|ವ|ು|ದ|ು
ಮಾಡುತ್ತ	V.PTCP;PRS	ಮಾಡ|ು|ತ್|ತ
ಮಾಡುತ್ತಾ	V.PTCP;PRS	ಮಾಡ|ು|ತ್ತ|ಾ
ಮಾಡುವರು	V;3;PL;FEM;FUT	ಮಾಡ|ು|ವ|ರ|ು
ಮಾಡುವೆ	V;1;SG;FUT	ಮಾಡ|ು|ವ|ೆ
ಮಾಡುತ್ತೇನೆ	V;1;SG;PRS	ಮಾಡ|ು|ತ್ತ|ೇ|ನ|ೆ
ಮಾಡದ	V.PTCP;NEG;LGSPEC1	ಮಾ|ಡ|ದ
ಮಾಡಿರಿ	V;2;PL;IMP	ಮಾಡ|ಿ|ರ|ಿ
ಮಾಡದೆ	V.PTCP;NEG	ಮಾ|ಡ|ದ|ೆ
ಮಾಡಿದೆ	V;2;SG;PST	ಮಾಡಿ|ದ|ೆ
ಮಾಡುತ್ತೀರಿ	V;2;PL;PRS	ಮಾಡ|ು|ತ್ತ|ೀ|ರ|ಿ
ಮಾಡಿದ	V;3;SG;MASC;PST	ಮಾಡ|ಿ|ದ
ಮಾಡಲಿ	V;NFIN;OPT	ಮಾ|ಡ|ಲ|ಿ
ಮಾಡಿತು	V;3;SG;NEUT;PST	ಮಾಡ|ಿತ|ು
ಮಾಡುತ್ತಾನೆ	V;3;SG;MASC;PRS	ಮಾಡ|ು|ತ್ತ|ಾ|ನ|ೆ
ಮಾಡಿದರು	V;3;PL;FEM;PST	ಮಾಡ|ಿ|ದ|ರ|ು
ಮಾಡೋಣ	V;1;PL;IMP	ಮಾಡ|ೋಣ
ಮಾಡಲಿಕ್ಕೆ	V;NFIN;LGSPEC2	ಮಾ|ಡ|ಲ|ಿ|ಕ್ಕ|ೆ
ಮಾಡಿದರೆ	V;NFIN;COND	ಮಾಡ|ಿ|ದ|ರ|ೆ
ಮಾಡುತ್ತವೆ	V;3;PL;NEUT;PRS	ಮಾಡು|ತ್|ತ|ವ|ೆ
ಮಾಡಿದೆವು	V;1;PL;PST	ಮಾಡ|ಿದ|ೆ|ವ|ು
ಮಾಡುತ್ತೇವೆ	V;1;PL;PRS	ಮಾಡ|ು|ತ್ತ|ೇ|ವ|ೆ
ಮಾಡಿ	V.PTCP;PST	ಮಾಡ|ಿ
ಮಾಡಿದನು	V;3;SG;MASC;PST	ಮಾಡ|ಿ|ದ|ನ|ು
ಮಾಡುವುವು	V;3;PL;NEUT;FUT	ಮಾಡ|ು|ವ|ು|ವ|ು
ಮಾರ್ಗಗಳು	N;PL;NOM	ಮಾರ್ಗ|ಗಳು
ಮಾರ್ಗಗಳ	N;PL;GEN	ಮಾರ್ಗ|ಗ|ಳ
ಮಾರ್ಗದಿಂದ	N;SG;INS	ಮಾರ್ಗ|ದ|ಿ|ಂದ
ಮಾರ್ಗವನ್ನು	N;SG;ACC	ಮಾರ್ಗ|ವ|ನ್ನು
ಮಾರ್ಗಗಳನ್ನು	N;PL;ACC	ಮಾರ್ಗ|ಗ|ಳ|ನ್ನು
ಮಾರ್ಗದ	N;SG;GEN	ಮಾರ್ಗ|ದ
ಮಾರ್ಗಗಳಿಗೆ	N;PL;DAT	ಮಾರ್ಗ|ಗಳ|ಿ|ಗೆ
ಮಾರ್ಗವು	N;SG;NOM	ಮಾರ್ಗ|ವ|ು
ಮೀಯುತ್ತಾರೆ	V;3;PL;FEM;PRS	ಮೀಯ|ು|ತ್ತ|ಾ|ರ|ೆ
ಯಾತ್ರಾರ್ಥಿಗಳ	N;PL;GEN	ಯಾತ್ರಾರ್ಥಿ|ಗ|ಳ
ಯಾತ್ರಿಕರು	N;PL;NOM	ಯಾತ್ರಿಕ|ರ|ು
ಯಾತ್ರಿಕರಿಗೆ	N;PL;DAT	ಯಾತ್ರಿಕ|ರ|ಿ|ಗೆ
ಯಾತ್ರಿಕನು	N;SG;NOM	ಯಾತ್ರ|ಿ|ಕ|ನ|ು
ವನದ	N;SG;GEN	ವನ|ದ
ವನಕ್ಕೆ	N;SG;DAT	ವನ|ಕ್ಕೆ
ವನವು	N;SG;NOM	ವನ|ವ|ು
ವಾಕ್ಯಗಳು	N;PL;NOM	ವಾಕ್ಯ|ಗಳು
ವಾಕ್ಯಗಳಿಂದ	N;PL;INS	ವಾಕ್ಯ|ಗಳ|ಿ|ಂದ
ವಾಕ್ಯಗಳ	N;PL;GEN	ವಾಕ್ಯ|ಗ|ಳ
ವಾಕ್ಯವನ್ನು	N;SG;ACC	ವಾಕ್ಯ|ವ|ನ್ನು
ವಾಕ್ಯಗಳನ್ನು	N;PL;ACC	ವಾಕ್ಯ|ಗ|ಳ|ನ್ನು
ವಾಕ್ಯದ	N;SG;GEN	ವಾಕ್ಯ|ದ
ವಾಕ್ಯಕ್ಕೆ	N;SG;DAT	ವಾಕ್ಯ|ಕ್ಕೆ
ವಿದ್ಯುತ್ತಿನ	N;SG;GEN	ವಿದ್ಯುತ್|ತ|ಿ|ನ
ಶಕ್ತಿಗಳು	N;PL;NOM	ಶಕ್ತಿ|ಗಳು
ಶಕ್ತಿಗಳಿಂದ	N;PL;INS	ಶಕ್ತಿ|ಗಳ|ಿ|ಂದ
ಶಕ್ತಿಯಿಂದ	N;SG;INS	ಶಕ್ತಿ|ಯ|ಿ|ಂದ
ಶಕ್ತಿಯನ್ನು	N;SG;ACC	ಶಕ್ತ|ಿ|ಯ|ನ್ನು
ಶಕ್ತಿಗಳನ್ನು	N;PL;ACC	ಶಕ್ತಿ|ಗ|ಳ|ನ್ನು
ಶಕ್ತಿಯ	N;SG;GEN	ಶಕ್ತ|ಿ|ಯ
ಶಕ್ತಿಗೆ	N;SG;DAT	ಶಕ್ತಿ|ಗೆ
ಶಕ್ತಿಯು	N;SG;NOM	ಶಕ್ತ|ಿ|ಯ|ು
ಸಂತೋಷದಿಂದ	N;SG;INS	ಸಂತೋಷ|ದ|ಿ|ಂದ
ಸಂತೋಷವನ್ನು	N;SG;ACC	ಸಂತೋಷ|ವ|ನ್ನು
ಸಂದೇಹಗಳನ್ನು	N;PL;ACC	ಸಂದೇಹ|ಗ|ಳ|ನ್ನು
ಸಂದೇಹಕ್ಕೆ	N;SG;DAT	ಸಂದೇಹ|ಕ್ಕೆ
ಸರೋವರಗಳು	N;PL;NOM	ಸರೋವರ|ಗಳು
ಸರೋವರಗಳ	N;PL;GEN	ಸರೋವರ|ಗ|ಳ
ಸರೋವರದಿಂದ	N;SG;INS	ಸರೋವರ|ದ|ಿ|ಂದ
ಸರೋವರವನ್ನು	N;SG;ACC	ಸರೋವರ|ವ|ನ್ನು
ಸರೋವರದ	N;SG;GEN	ಸರೋವರ|ದ
ಸಾಯಿಸಲು	V;NFIN	ಸಾಯಿಸ|ಲ|ು
ಸಾಯಿಸುವುದು	V;3;SG;NEUT;FUT	ಸಾಯಿಸ|ು|ವ|ು|ದ|ು
ಸಾಯಿಸಿದ	V;3;SG;MASC;PST	ಸಾಯ|ಿ|ಸ|ಿ|ದ
ಸಾಯಿಸಿದರೆ	V;NFIN;COND	ಸಾಯಿಸ|ಿ|ದ|ರ|ೆ
ಸಾಯಿಸಿ	V.PTCP;PST	ಸಾಯಿಸ|ಿ
ಸಿಂಹಗಳು	N;PL;NOM	ಸಿಂಹ|ಗಳು
ಸಿಂಹದ	N;SG;GEN	ಸಿಂಹ|ದ
ಸಿಂಹಕ್ಕೆ	N;SG;DAT	ಸಿಂಹ|ಕ್ಕೆ
ಸುಂಟರಗಾಳಿಯ	N;SG;GEN	ಸುಂಟರಗಾಳ|ಿ|ಯ
ಸೂರ್ಯನನ್ನು	N;SG;ACC	ಸೂರ್ಯ|ನ|ನ|್|ನು
ಸೂರ್ಯನ	N;SG;GEN	ಸೂರ್ಯ|ನ
ಹಲ್ಲುಗಳು	N;PL;NOM	ಹಲ್ಲು|ಗಳು
ಹಲ್ಲುಗಳಿಂದ	N;PL;INS	ಹಲ್ಲು|ಗಳ|ಿ|ಂದ
ಹಲ್ಲುಗಳನ್ನು	N;PL;ACC	ಹಲ್ಲು|ಗ|ಳ|ನ್ನು
ಹಾಡುವ	V.PTCP;FUT;LGSPEC1	ಹಾಡ|ು|ವ
ಹಾಡಲು	V;NFIN	ಹಾ|ಡ|ಲ|ು
ಹಾಡಿ	V.PTCP;PST	ಹಾಡ|ಿ
ಹಾಲಿನಿಂದ	N;SG;INS	ಹಾಲ|ಿ|ನ|ಿ|ಂದ
ಹಾಲನ್ನು	N;SG;ACC	ಹಾ|ಲ|ನ್ನು
ಹಾಲಿನ	N;SG;GEN	ಹಾಲ|ಿ|ನ
ಹಾಸಿಗೆಗಳು	N;PL;NOM	ಹಾಸಿಗೆ|ಗಳು
ಹಾಸಿಗೆಯ	N;SG;GEN	ಹಾಸಿಗ|ೆ|ಯ
ಹುಟ್ಟುವ	V.PTCP;FUT;LGSPEC1	ಹುಟ್ಟ|ು|ವ
ಹುಟ್ಟುತ್ತದೆ	V;3;SG;NEUT;PRS	ಹುಟ್ಟ|ು|ತ್|ತ|ದ|ೆ
ಹುಟ್ಟುವುದು	V;3;SG;NEUT;FUT	ಹುಟ್ಟ|ು|ವ|ು|ದ|ು
ಹುಟ್ಟಿದೆ	V;2;SG;PST	ಹುಟ್ಟ|ಿ|ದ|ೆ
ಹುಟ್ಟಿದ	V;3;SG;MASC;PST	ಹುಟ್ಟ|ಿ|ದ
ಹುಟ್ಟುತ್ತೇವೆ	V;1;PL;PRS	ಹುಟ್ಟ|ು|ತ್ತ|ೇ|ವ|ೆ
ಹುಟ್ಟಿ	V.PTCP;PST	ಹುಟ್ಟ|ಿ
ಹುಡುಗರ	N;PL;GEN	ಹುಡುಗ|ರ
ಹುಡುಗನನ್ನು	N;SG;ACC	ಹುಡುಗ|ನ|ನ|್|ನು
ಹುಡುಗನ	N;SG;GEN	ಹುಡುಗ|ನ
ಹುಡುಗನು	N;SG;NOM	ಹುಡುಗ|ನ|ು
ಹೃದಯದಿಂದ	N;SG;INS	ಹೃದಯ|ದ|ಿ|ಂದ
ಹೃದಯದ	N;SG;GEN	ಹೃದಯ|ದ
ಹೆಸರಿಸುತ್ತಾರೆ	V;3;PL;FEM;PRS	ಹೆಸರ|ಿ|ಸ|ು|ತ್ತಾರೆ
ಹೆಸರಿಸುವುದು	V;3;SG;NEUT;FUT	ಹೆಸರ|ಿ|ಸ|ು|ವುದು
ಹೆಸರಿಸಿ	V.PTCP;PST	ಹೆಸರ|ಿ|ಸ|ಿ
ಹೆಸರುಗಳು	N;PL;NOM	ಹೆಸರು|ಗಳು
ಹೆಸರುಗಳಿಂದ	N;PL;INS	ಹೆಸರು|ಗಳ|ಿ|ಂದ
ಹೆಸರಿನಿಂದ	N;SG;INS	ಹೆಸರ|ಿನ|ಿ|ಂದ
ಹೆಸರನ್ನು	N;SG;ACC	ಹೆಸರ|ನ್ನು
ಹೆಸರುಗಳನ್ನು	N;PL;ACC	ಹೆಸರು|ಗ|ಳ|ನ್ನು
ಹೆಸರಿನ	N;SG;GEN	ಹೆಸರ|ಿ|ನ
ಹೇಳುವ	V.PTCP;FUT;LGSPEC1	ಹೇಳ|ು|ವ
ಹೇಳಲು	V;NFIN	ಹೇಳ|ಲ|ು
ಹೇಳುತ್ತಾರೆ	V;3;PL;FEM;PRS	ಹೇಳ|ು|ತ್ತ|ಾ|ರ|ೆ
ಹೇಳುತ್ತದೆ	V;3;SG;NEUT;PRS	ಹೇಳ|ು|ತ್|ತ|ದ|ೆ
ಹೇಳುವುದು	V;3;SG;NEUT;FUT	ಹೇಳ|ು|ವ|ು|ದ|ು
ಹೇಳುತ್ತಾ	V.PTCP;PRS	ಹೇಳ|ು|ತ್ತ|ಾ
ಹೇಳುವರು	V;3;PL;FEM;FUT	ಹೇಳ|ು|ವ|ರ|ು
ಹೇಳುತ್ತೇನೆ	V;1;SG;PRS	ಹೇಳು|ತ್ತ|ೇ|ನ|ೆ
ಹೇಳುವೆನು	V;1;SG;FUT	ಹೇಳ|ು|ವ|ೆ|ನ|ು
ಹೇಳಿರಿ	V;2;PL;IMP	ಹೇಳ|ಿ|ರ|ಿ
ಹೇಳದೆ	V.PTCP;NEG	ಹೇಳ|ದ|ೆ
ಹೇಳಿದೆ	V;2;SG;PST	ಹೇಳ|ಿ|ದ|ೆ
ಹೇಳಿದ	V;3;SG;MASC;PST	ಹೇಳ|ಿ|ದ
ಹೇಳಲಿ	V;NFIN;OPT	ಹೇ|ಳ|ಲ|ಿ
ಹೇಳಿತು	V;3;SG;NEUT;PST	ಹೇಳ|ಿ|ತ|ು
ಹೇಳಿದರು	V;3;PL;FEM;PST	ಹೇಳ|ಿ|ದ|ರ|ು
ಹೇಳೋಣ	V;1;PL;IMP	ಹೇಳ|ೋ|ಣ
ಹೇಳಿದರೆ	V;NFIN;COND	ಹೇಳ|ಿ|ದ|ರೆ
ಹೇಳಿ	V.PTCP;PST	ಹೇಳ|ಿ
ಹೇಳಿದನು	V;3;SG;MASC;PST	ಹೇಳ|ಿ|ದ|ನ|ು
ಹೊರಡುವ	V.PTCP;FUT;LGSPEC1	ಹೊರಡ|ು|ವ
ಹೊರಡುತ್ತದೆ	V;3;SG;NEUT;PRS	ಹೊರಡ|ು|ತ್|ತ|ದ|ೆ
ಹೊರಡೋಣ	V;1;PL;IMP	ಹೊರಡ|ೋ|ಣ
ಹೊಲದ	N;SG;GEN	ಹೊಲ|ದ
ಹೊಲಕ್ಕೆ	N;SG;DAT	ಹೊಲ|ಕ್ಕೆ
ಹೋಗುತ್ತಾರೆ	V;3;PL;FEM;PRS	ಹೋಗ|ು|ತ್ತ|ಾ|ರ|ೆ
ಹೋಗುತ್ತದೆ	V;3;SG;NEUT;PRS	ಹೋಗ|ು|ತ್|ತ|ದ|ೆ
ಹೋಗುವ	V.PTCP;FUT;LGSPEC1	ಹೋಗ|ು|ವ
ಹೋಗುವುದು	V;3;SG;NEUT;FUT	ಹೋಗ|ು|ವ|ು|ದ|ು
ಹೋಗುತ್ತಾ	V.PTCP;PRS	ಹೋಗ|ು|ತ್ತ|ಾ
ಹೋಗುವರು	V;3;PL;FEM;FUT	ಹೋಗ|ು|ವ|ರ|ು
ಹೋಗುತ್ತೇನೆ	V;1;SG;PRS	ಹೋಗ|ು|ತ್ತ|ೇ|ನ|ೆ
ಹೋದಳು	V;3;SG;FEM;PST	ಹೋ|ದ|ಳ|ು
ಹೋಗದೆ	V.PTCP;NEG	ಹೋಗ|ದ|ೆ
ಹೋದ	V.PTCP;PST;LGSPEC1	ಹೋ|ದ
ಹೋಗಲಿ	V;NFIN;OPT	ಹೋ|ಗ|ಲ|ಿ
ಹೋಯಿತು	V;3;SG;NEUT;PST	ಹೋ|ಯ|ಿ|ತ|ು
ಹೋದರು	V;3;PL;FEM;PST	ಹೋ|ದ|ರ|ು
ಹೋಗೋಣ	V;1;PL;IMP	ಹೋಗ|ೋಣ
ಹೋದರೆ	V;NFIN;COND	ಹೋ|ದ|ರ|ೆ
ಹೋಗುತ್ತವೆ	V;3;PL;NEUT;PRS	ಹೋಗ|ು|ತ್|ತ|ವ|ೆ
ಹೋದೆವು	V;1;PL;PST	ಹೋ|ದ|ೆ|ವ|ು
ಹೋಗಿ	V.PTCP;PST	ಹೋಗ|ಿ
