aalglad	ADJ;INDF;NEUT;SG	aal|glad
aalvormig	ADJ;INDF;NEUT;SG	aal|vorm|ig
aamborstig	ADJ;INDF;NEUT;SG	aam|borst|ig
aanbiddelijk	ADJ;INDF;NEUT;SG	aan|bidd|elijk
aanbidden	V;SBJV;PRS;PL	aan|bidd|en
aangeboren	ADJ;INDF;PL	aan|geboren
aanmerkelijk	ADJ;INDF;NEUT;SG	aan|merk|elijk
aanneembaar	ADJ;INDF;NEUT;SG	aan|neem|baar
aannemelijk	ADJ;INDF;NEUT;SG	aan|nem|elijk
aanschouwelijk	ADJ;INDF;NEUT;SG	aan|schouw|elijk
aanschouwen	V;SBJV;PRS;PL	aan|schouw|en
aansprakelijk	ADJ;INDF;NEUT;SG	aan|sprak|elijk
aantrekkelijk	ADJ;INDF;NEUT;SG	aan|trekk|elijk
aanvaardbaar	ADJ;INDF;NEUT;SG	aanvaard|baar
aanvankelijk	ADJ;INDF;NEUT;SG	aan|vank|elijk
aanverwant	ADJ;INDF;NEUT;SG	aan|verwant
aanverwante	ADJ;INDF;PL	aan|verwant|e
aanzienlijk	ADJ;INDF;NEUT;SG	aanzien|lijk
aardewerk	ADJ;INDF;PL	aarde|werk
aardewerken	ADJ;INDF;PL	aarde|werk|en
aards	ADJ;INDF;NEUT;SG	aard|s
aartsvaderlijk	ADJ;INDF;NEUT;SG	aarts|vader|lijk
aarzelen	V;SBJV;PRS;PL	aarzel|en
aborteren	V;SBJV;PRS;PL	abort|er|en
absoluut	ADJ;INDF;NEUT;SG	absoluut
abstraheren	V;SBJV;PRS;PL	abstrah|er|en
accentueren	V;SBJV;PRS;PL	accent|uer|en
accepteren	V;SBJV;PRS;PL	accept|er|en
accuraat	ADJ;INDF;NEUT;SG	accuraat
achteloos	ADJ;INDF;NEUT;SG	acht|eloos
achten	V;SBJV;PRS;PL	acht|en
acht	V;IND;PRS;3;SG	acht
achterdochtig	ADJ;INDF;NEUT;SG	achterdocht|ig
achterhalen	V;SBJV;PRS;PL	achter|hal|en
achterlijk	ADJ;INDF;NEUT;SG	achter|lijk
achtervolgen	V;SBJV;PRS;PL	achter|volg|en
achterwaarts	ADJ;INDF;NEUT;SG	achter|waarts
achthoekig	ADJ;INDF;NEUT;SG	acht|hoek|ig
achttienjarig	ADJ;INDF;NEUT;SG	acht|tien|jar|ig
achturig	ADJ;INDF;NEUT;SG	acht|ur|ig
achtvoudig	ADJ;INDF;NEUT;SG	achtvoud|ig
actief	ADJ;INDF;NEUT;SG	act|ief
activeren	V;SBJV;PRS;PL	activ|er|en
adelen	V;SBJV;PRS;PL	adel|en
adel	V;IND;PRS;1;SG	adel
adellijk	ADJ;INDF;NEUT;SG	adel|lijk
adembenemend	ADJ;INDF;NEUT;SG	adem|be|nem|end
ademen	V;SBJV;PRS;PL	adem|en
adem	V;IND;PRS;1;SG	adem
administratief	ADJ;INDF;NEUT;SG	administr|at|ief
adoptief	ADJ;INDF;NEUT;SG	adopt|ief
adviseren	V;SBJV;PRS;PL	advis|er|en
aerodynamisch	ADJ;INDF;NEUT;SG	aero|dynamisch
afgrijselijk	ADJ;INDF;NEUT;SG	afgrijs|elijk
afhankelijk	ADJ;INDF;NEUT;SG	af|hank|elijk
afkeurenswaardig	ADJ;INDF;NEUT;SG	af|keur|ens|waard|ig
afkomstig	ADJ;INDF;NEUT;SG	af|kom|st|ig
afschrikwekkend	ADJ;INDF;NEUT;SG	af|schrik|wekk|end
afschuwelijk	ADJ;INDF;NEUT;SG	afschuw|elijk
afstandelijk	ADJ;INDF;NEUT;SG	afstand|elijk
aftelbaar	ADJ;INDF;NEUT;SG	af|tel|baar
afvallig	ADJ;INDF;NEUT;SG	af|vall|ig
afzonderlijk	ADJ;INDF;NEUT;SG	af|zonder|lijk
agogiek	ADJ;INDF;NEUT;SG	agog|iek
agressief	ADJ;INDF;NEUT;SG	agress|ief
alarmeren	V;SBJV;PRS;PL	alarm|er|en
alfabetisch	ADJ;INDF;NEUT;SG	alfabet|isch
algeheel	ADJ;INDF;NEUT;SG	al|geheel
alledaags	ADJ;INDF;NEUT;SG	alle|daag|s
alleenstaand	ADJ;INDF;NEUT;SG	alleen|staand
almachtig	ADJ;INDF;NEUT;SG	al|macht|ig
alomtegenwoordig	ADJ;INDF;NEUT;SG	alom|tegenwoordig
aloud	ADJ;INDF;NEUT;SG	al|oud
alternatief	ADJ;INDF;NEUT;SG	altern|at|ief
altijddurend	ADJ;INDF;NEUT;SG	altijd|dur|end
ambtelijk	ADJ;INDF;NEUT;SG	ambt|elijk
ambteloos	ADJ;INDF;NEUT;SG	ambt|eloos
analyseren	V;SBJV;PRS;PL	analys|er|en
anderstalige	ADJ;INDF;PL	anders|tal|ig|e
anglicaans	ADJ;INDF;NEUT;SG	anglicaan|s
angstaanjagend	ADJ;INDF;NEUT;SG	angst|aan|jag|end
angstig	ADJ;INDF;NEUT;SG	angst|ig
angstwekkend	ADJ;INDF;NEUT;SG	angst|wekk|end
ankeren	V;SBJV;PRS;PL	anker|en
anker	V;IND;PRS;1;SG	anker
annexeren	V;SBJV;PRS;PL	annex|er|en
antarctisch	ADJ;INDF;NEUT;SG	antarct|isch
antedateren	V;SBJV;PRS;PL	ante|dater|en
antiek	ADJ;INDF;NEUT;SG	antiek
applaudisseren	V;SBJV;PRS;PL	applaudiss|er|en
arbeiden	V;SBJV;PRS;PL	arbeid|en
arbeid	V;IND;PRS;1;SG	arbeid
arceren	V;SBJV;PRS;PL	arcer|en
archiveren	V;SBJV;PRS;PL	archiv|er|en
argumenteren	V;SBJV;PRS;PL	argument|er|en
aristocratisch	ADJ;INDF;NEUT;SG	aristocrat|isch
armoedig	ADJ;INDF;NEUT;SG	armoed|ig
aromatisch	ADJ;INDF;NEUT;SG	arom|atisch
arresteren	V;SBJV;PRS;PL	arrest|er|en
asociaal	ADJ;INDF;NEUT;SG	a|sociaal
assertief	ADJ;INDF;NEUT;SG	assert|ief
asymmetrisch	ADJ;INDF;NEUT;SG	a|symmetrisch
asymptomatisch	ADJ;INDF;NEUT;SG	a|symptom|atisch
atmosferisch	ADJ;INDF;NEUT;SG	atmosfer|isch
attesteren	V;SBJV;PRS;PL	attest|er|en
attractief	ADJ;INDF;NEUT;SG	attract|ief
attributief	ADJ;INDF;NEUT;SG	attribut|ief
auditief	ADJ;INDF;NEUT;SG	audit|ief
automatisch	ADJ;INDF;NEUT;SG	automat|isch
avanceren	V;SBJV;PRS;PL	avanc|er|en
avontuurlijk	ADJ;INDF;NEUT;SG	avontuur|lijk
baanbrekend	ADJ;INDF;NEUT;SG	baan|brek|end
baardig	ADJ;INDF;NEUT;SG	baard|ig
babbelen	V;SBJV;PRS;PL	babbel|en
babbel	V;IND;PRS;1;SG	babbel
bacterieel	ADJ;INDF;NEUT;SG	bacter|ieel
bagger	V;IND;PRS;1;SG	bagger
baggeren	V;SBJV;PRS;PL	bagger|en
bakeren	V;SBJV;PRS;PL	baker|en
baker	V;IND;PRS;1;SG	baker
bakstenen	ADJ;INDF;PL	bak|sten|en
ballen	V;SBJV;PRS;PL	ball|en
bal	V;IND;PRS;1;SG	bal
balsemen	V;SBJV;PRS;PL	balsem|en
balsem	V;IND;PRS;1;SG	balsem
banaal	ADJ;INDF;NEUT;SG	banaal
bangelijk	ADJ;INDF;NEUT;SG	bang|elijk
barbaars	ADJ;INDF;NEUT;SG	barbaar|s
barbecue	V;IND;PRS;1;SG	barbecue
barnen	V;SBJV;PRS;PL	barnen
barn	V;IND;PRS;1;SG	barn
barok	ADJ;INDF;NEUT;SG	barok
bars	ADJ;INDF;NEUT;SG	bars
barvoets	ADJ;INDF;NEUT;SG	bar|voet|s
baseren	V;SBJV;PRS;PL	bas|er|en
bazelen	V;SBJV;PRS;PL	bazel|en
bazig	ADJ;INDF;NEUT;SG	baz|ig
beangstigen	V;SBJV;PRS;PL	be|angst|ig|en
beantwoorden	V;SBJV;PRS;PL	be|antwoord|en
bebloed	ADJ;INDF;NEUT;SG	be|bloed
beboeten	V;SBJV;PRS;PL	be|boet|en
bebossen	V;SBJV;PRS;PL	be|boss|en
bebouwen	V;SBJV;PRS;PL	be|bouw|en
bebroeden	V;SBJV;PRS;PL	be|broed|en
becijferen	V;SBJV;PRS;PL	be|cijfer|en
bedachtzaam	ADJ;INDF;NEUT;SG	bedacht|zaam
bedanken	V;SBJV;PRS;PL	be|dank|en
bedekken	V;SBJV;PRS;PL	be|dekk|en
bedelven	V;SBJV;PRS;PL	be|delven
bedenkelijk	ADJ;INDF;NEUT;SG	be|denk|elijk
bedenken	V;SBJV;PRS;PL	be|denk|en
bederven	V;SBJV;PRS;PL	be|derven
bedienen	V;SBJV;PRS;PL	be|dienen
bedingen	V;SBJV;PRS;PL	be|ding|en
bedlegerig	ADJ;INDF;NEUT;SG	bed|legerig
bedoelen	V;SBJV;PRS;PL	be|doel|en
bedonderen	V;SBJV;PRS;PL	be|donder|en
bedotten	V;SBJV;PST;PL	be|dott|en
bedreigen	V;SBJV;PRS;PL	be|dreig|en
bedrieglijk	ADJ;INDF;NEUT;SG	bedrieg|lijk
bedroeven	V;SBJV;PRS;PL	be|droeven
bedruipen	V;SBJV;PRS;PL	be|druip|en
bedrukken	V;SBJV;PRS;PL	be|drukk|en
beduiden	V;SBJV;PRS;PL	be|duid|en
beduvelen	V;SBJV;PRS;PL	be|duvel|en
bedwingen	V;SBJV;PRS;PL	be|dwing|en
beeldig	ADJ;INDF;NEUT;SG	beeld|ig
beeldschoon	ADJ;INDF;NEUT;SG	beeld|schoon
begaanbaar	ADJ;INDF;NEUT;SG	begaan|baar
begeleiden	V;SBJV;PRS;PL	be|ge|leid|en
begeren	V;SBJV;PRS;PL	be|ger|en
begerig	ADJ;INDF;NEUT;SG	be|ger|ig
begrenzen	V;SBJV;PRS;PL	be|grenzen
begrijpelijk	ADJ;INDF;NEUT;SG	be|grijp|elijk
begrijpen	V;SBJV;PRS;PL	be|grijp|en
begroeien	V;SBJV;PRS;PL	be|groei|en
begroeten	V;SBJV;PRS;PL	be|groet|en
begroten	V;SBJV;PRS;PL	be|grot|en
begunstigen	V;SBJV;PRS;PL	be|gun|st|ig|en
behaaglijk	ADJ;INDF;NEUT;SG	be|haag|lijk
behaagziek	ADJ;INDF;NEUT;SG	be|haag|ziek
behagen	V;SBJV;PRS;PL	be|hag|en
behalen	V;SBJV;PRS;PL	be|hal|en
behandelen	V;SBJV;PRS;PL	be|handel|en
behartigen	V;SBJV;PRS;PL	be|hart|ig|en
beheersen	V;SBJV;PRS;PL	be|heers|en
behoeden	V;SBJV;PRS;PL	be|hoed|en
behoedzaam	ADJ;INDF;NEUT;SG	be|hoed|zaam
behoeftig	ADJ;INDF;NEUT;SG	behoeft|ig
behoeven	V;SBJV;PRS;PL	be|hoeven
behoorlijk	ADJ;INDF;NEUT;SG	be|hoor|lijk
behoren	V;SBJV;PRS;PL	be|hor|en
beige	ADJ;INDF;PL	beige
bejubelen	V;SBJV;PRS;PL	be|jubel|en
bekakken	V;SBJV;PRS;PL	be|kakk|en
bekijken	V;SBJV;PRS;PL	be|kijk|en
beklagen	V;SBJV;PRS;PL	be|klag|en
beklagenswaardig	ADJ;INDF;NEUT;SG	be|klag|ens|waard|ig
bekleden	V;SBJV;PRS;PL	be|kled|en
beklemmen	V;SBJV;PRS;PL	be|klemm|en
beklemtonen	V;SBJV;PRS;PL	be|klem|tonen
beklimmen	V;SBJV;PRS;PL	be|klimm|en
beknibbelen	V;SBJV;PRS;PL	be|knibbel|en
bekommeren	V;SBJV;PRS;PL	be|kommer|en
bekoorlijk	ADJ;INDF;NEUT;SG	bekoor|lijk
bekopen	V;SBJV;PRS;PL	be|kop|en
bekorten	V;SBJV;PRS;PL	be|kort|en
bekostigen	V;SBJV;PRS;PL	be|kost|ig|en
bekrachtigen	V;SBJV;PRS;PL	be|kracht|ig|en
bekritiseren	V;SBJV;PRS;PL	be|kritiser|en
bekronen	V;SBJV;PRS;PL	be|kronen
bekruipen	V;SBJV;PRS;PL	be|kruip|en
belanden	V;SBJV;PRS;PL	be|land|en
belanghebbend	ADJ;INDF;NEUT;SG	belang|hebb|end
belangrijk	ADJ;INDF;NEUT;SG	belang|rijk
belastbaar	ADJ;INDF;NEUT;SG	be|last|baar
belasten	V;SBJV;PRS;PL	be|last|en
belasteren	V;SBJV;PRS;PL	be|laster|en
belazeren	V;SBJV;PRS;PL	be|lazer|en
beledigen	V;SBJV;PRS;PL	beledig|en
belegeren	V;SBJV;PRS;PL	be|leger|en
beleggen	V;SBJV;PRS;PL	be|legg|en
belemmeren	V;SBJV;PRS;PL	belemmer|en
belenen	V;SBJV;PRS;PL	be|lenen
beletten	V;SBJV;PST;PL	be|lett|en
beleven	V;SBJV;PRS;PL	be|leven
belichamen	V;SBJV;PRS;PL	be|licham|en
belichten	V;SBJV;PRS;PL	be|licht|en
belijden	V;SBJV;PRS;PL	be|lijd|en
belonen	V;SBJV;PRS;PL	be|lonen
beluisteren	V;SBJV;PRS;PL	be|luister|en
bemachtigen	V;SBJV;PRS;PL	be|macht|ig|en
bemannen	V;SBJV;PRS;PL	be|mannen
bemerken	V;SBJV;PRS;PL	be|merk|en
bemiddeld	V.PTCP;PST	be|middel|d
bemiddelen	V;SBJV;PRS;PL	be|middel|en
beminnelijk	ADJ;INDF;NEUT;SG	be|minn|elijk
beminnen	V;SBJV;PRS;PL	be|minnen
bemoedigen	V;SBJV;PRS;PL	be|moed|ig|en
bemoeien	V;SBJV;PRS;PL	be|moei|en
benadelen	V;SBJV;PRS;PL	be|nadel|en
benaderen	V;SBJV;PRS;PL	be|nader|en
benadrukken	V;SBJV;PRS;PL	be|na|drukk|en
benauwen	V;SBJV;PRS;PL	be|nauw|en
benedenwaarts	ADJ;INDF;NEUT;SG	beneden|waarts
benedenwinds	ADJ;INDF;NEUT;SG	beneden|wind|s
benedictijner	ADJ;INDF;PL	benedictijn|er
benemen	V;SBJV;PRS;PL	be|nem|en
benieuwen	V;SBJV;PRS;PL	be|nieuw|en
benig	ADJ;INDF;NEUT;SG	ben|ig
benodigd	V.PTCP;PST	be|nodig|d
benoemen	V;SBJV;PRS;PL	be|noem|en
benutten	V;SBJV;PST;PL	be|nutt|en
beoefenen	V;SBJV;PRS;PL	be|oefenen
beogen	V;SBJV;PRS;PL	be|og|en
beoordelen	V;SBJV;PRS;PL	be|oor|del|en
bepalen	V;SBJV;PRS;PL	be|pal|en
bepeinzen	V;SBJV;PRS;PL	be|peinzen
beperken	V;SBJV;PRS;PL	be|perk|en
beplakken	V;SBJV;PRS;PL	be|plakk|en
bepleiten	V;SBJV;PRS;PL	be|pleit|en
bepraten	V;SBJV;PRS;PL	be|prat|en
beramen	V;SBJV;PRS;PL	be|ram|en
berechten	V;SBJV;PRS;PL	be|recht|en
beredeneren	V;SBJV;PRS;PL	be|reden|er|en
bereikbaar	ADJ;INDF;NEUT;SG	be|reik|baar
berekenen	V;SBJV;PRS;PL	be|rekenen
bergachtig	ADJ;INDF;NEUT;SG	berg|achtig
beroepsmatig	ADJ;INDF;NEUT;SG	beroep|s|matig
beroeren	V;SBJV;PRS;PL	be|roer|en
berooid	ADJ;INDF;NEUT;SG	be|rooi|d
berouwvol	ADJ;INDF;NEUT;SG	berouw|vol
beroven	V;SBJV;PRS;PL	be|roven
bersten	V;SBJV;PRS;PL	berst|en
berst	V;IND;PRS;3;SG	berst
berusten	V;SBJV;PRS;PL	be|rust|en
beschaven	V;SBJV;PRS;PL	be|schaven
beschermen	V;SBJV;PRS;PL	be|scherm|en
beschieten	V;SBJV;PRS;PL	be|schiet|en
beschijnen	V;SBJV;PRS;PL	be|schijnen
beschikbaar	ADJ;INDF;NEUT;SG	be|schik|baar
beschikken	V;SBJV;PRS;PL	be|schikk|en
beschilderen	V;SBJV;PRS;PL	be|schilder|en
beschimmelen	V;SBJV;PRS;PL	be|schimmel|en
beschimpen	V;SBJV;PRS;PL	be|schimp|en
beschouwen	V;SBJV;PRS;PL	be|schouw|en
beschrijven	V;SBJV;PRS;PL	be|schrijven
beschuldigen	V;SBJV;PRS;PL	be|schuld|ig|en
beschutten	V;SBJV;PST;PL	be|schutt|en
beslaan	V;SBJV;PRS;PL	be|slaa|n
beslechten	V;SBJV;PRS;PL	be|slecht|en
besluipen	V;SBJV;PRS;PL	be|sluip|en
besluiteloos	ADJ;INDF;NEUT;SG	besluit|eloos
besmeren	V;SBJV;PRS;PL	be|smer|en
besmettelijk	ADJ;INDF;NEUT;SG	be|smett|elijk
besmetten	V;SBJV;PST;PL	be|smett|en
besnijden	V;SBJV;PRS;PL	be|snijd|en
besparen	V;SBJV;PRS;PL	be|spar|en
bespelen	V;SBJV;PRS;PL	be|spel|en
bespeuren	V;SBJV;PRS;PL	be|speur|en
bespioneren	V;SBJV;PRS;PL	be|spion|er|en
bespotten	V;SBJV;PST;PL	be|spott|en
bespreken	V;SBJV;PRS;PL	be|sprek|en
bespringen	V;SBJV;PRS;PL	be|spring|en
besteedbaar	ADJ;INDF;NEUT;SG	besteed|baar
bestelen	V;SBJV;PRS;PL	be|stel|en
bestempelen	V;SBJV;PRS;PL	be|stempel|en
besterven	V;SBJV;PRS;PL	be|sterven
bestieren	V;SBJV;PRS;PL	be|stier|en
bestijgen	V;SBJV;PRS;PL	be|stijg|en
bestoken	V;SBJV;PRS;PL	be|stok|en
bestormen	V;SBJV;PRS;PL	be|storm|en
bestraffen	V;SBJV;PRS;PL	be|straff|en
bestralen	V;SBJV;PRS;PL	be|stral|en
bestrijden	V;SBJV;PRS;PL	be|strijd|en
bestrijken	V;SBJV;PRS;PL	be|strijk|en
bestuderen	V;SBJV;PRS;PL	be|studer|en
besturen	V;SBJV;PRS;PL	be|stur|en
bestuurlijk	ADJ;INDF;NEUT;SG	be|stuur|lijk
betaalbaar	ADJ;INDF;NEUT;SG	betaal|baar
betasten	V;SBJV;PRS;PL	be|tast|en
betegelen	V;SBJV;PRS;PL	be|tegel|en
betekenen	V;SBJV;PRS;PL	be|tekenen
betekenisvol	ADJ;INDF;NEUT;SG	betekenis|vol
beteugelen	V;SBJV;PRS;PL	be|teugel|en
betitelen	V;SBJV;PRS;PL	be|titel|en
betoveren	V;SBJV;PRS;PL	be|tover|en
betrachten	V;SBJV;PRS;PL	be|tracht|en
betrappen	V;SBJV;PRS;PL	be|trapp|en
betreffen	V;SBJV;PRS;PL	be|treff|en
betrekkelijk	ADJ;INDF;NEUT;SG	be|trekk|elijk
betrekken	V;SBJV;PRS;PL	be|trekk|en
betreuren	V;SBJV;PRS;PL	be|treur|en
betreurenswaardig	ADJ;INDF;NEUT;SG	be|treur|ens|waard|ig
betrouwbaar	ADJ;INDF;NEUT;SG	be|trouw|baar
betrouwen	V;SBJV;PRS;PL	be|trouw|en
betuigen	V;SBJV;PRS;PL	be|tuig|en
betwijfelen	V;SBJV;PRS;PL	be|twijfel|en
betwistbaar	ADJ;INDF;NEUT;SG	be|twist|baar
betwisten	V;SBJV;PRS;PL	be|twist|en
bevaarbaar	ADJ;INDF;NEUT;SG	be|vaar|baar
bevallig	ADJ;INDF;NEUT;SG	be|vall|ig
bevatten	V;SBJV;PST;PL	be|vatt|en
bevechten	V;SBJV;PRS;PL	be|vecht|en
bevochten	V;SBJV;PST;PL	be|vocht|en
bevederd	ADJ;INDF;NEUT;SG	be|veder|d
beveiligen	V;SBJV;PRS;PL	be|veilig|en
beven	V;SBJV;PRS;PL	beven
bevestigen	V;SBJV;PRS;PL	be|vestig|en
bevinden	V;SBJV;PRS;PL	be|vind|en
bevlekken	V;SBJV;PRS;PL	be|vlekk|en
bevochtigen	V;SBJV;PRS;PL	be|vocht|ig|en
bevolken	V;SBJV;PRS;PL	be|volk|en
bevoordelen	V;SBJV;PRS;PL	be|voor|del|en
bevooroordeeld	ADJ;INDF;NEUT;SG	be|voor|oor|deel|d
bevoorraden	V;SBJV;PRS;PL	be|voorrad|en
bevoorrechten	V;SBJV;PRS;PL	be|voor|recht|en
bevorderen	V;SBJV;PRS;PL	be|vorder|en
bevorderlijk	ADJ;INDF;NEUT;SG	be|vorder|lijk
bevredigen	V;SBJV;PRS;PL	be|vred|ig|en
bevreemden	V;SBJV;PRS;PL	be|vreemd|en
bevreesd	ADJ;INDF;NEUT;SG	be|vrees|d
bevriend	ADJ;INDF;NEUT;SG	be|vriend
bevriezen	V;SBJV;PRS;PL	be|vriezen
bevrijden	V;SBJV;PRS;PL	be|vrijd|en
bewaken	V;SBJV;PRS;PL	be|wak|en
bewapenen	V;SBJV;PRS;PL	be|wapenen
bewaren	V;SBJV;PRS;PL	be|war|en
beweegbaar	ADJ;INDF;NEUT;SG	beweeg|baar
beweeglijk	ADJ;INDF;NEUT;SG	beweeg|lijk
beweiden	V;SBJV;PRS;PL	be|weid|en
beweren	V;SBJV;PRS;PL	be|wer|en
bewerkelijk	ADJ;INDF;NEUT;SG	be|werk|elijk
bewerken	V;SBJV;PRS;PL	be|werk|en
bewerkstelligen	V;SBJV;PRS;PL	be|werkstellig|en
bewieroken	V;SBJV;PRS;PL	be|wierok|en
bewonderen	V;SBJV;PRS;PL	be|wonder|en
bewonderenswaardig	ADJ;INDF;NEUT;SG	be|wonder|ens|waard|ig
bewonen	V;SBJV;PRS;PL	be|wonen
bewoonbaar	ADJ;INDF;NEUT;SG	be|woon|baar
bezaaien	V;SBJV;PRS;PL	be|zaai|en
bezeren	V;SBJV;PRS;PL	be|zer|en
bezetten	V;SBJV;PST;PL	be|zett|en
bezichtigen	V;SBJV;PRS;PL	be|zicht|ig|en
bezielen	V;SBJV;PRS;PL	be|ziel|en
bezienswaardig	ADJ;INDF;NEUT;SG	be|zie|ns|waard|ig
bezig	ADJ;INDF;NEUT;SG	bezig
bezinnen	V;SBJV;PRS;PL	be|zinnen
bezitten	V;SBJV;PRS;PL	be|zitt|en
bezoeken	V;SBJV;PRS;PL	be|zoek|en
bezorgd	V.PTCP;PST	be|zorg|d
bezorgen	V;SBJV;PRS;PL	be|zorg|en
bezuinigen	V;SBJV;PRS;PL	be|zuinig|en
bezwaarlijk	ADJ;INDF;NEUT;SG	bezwaar|lijk
bezwaren	V;SBJV;PRS;PL	be|zwar|en
bezwendelen	V;SBJV;PRS;PL	be|zwendel|en
bezweren	V;SBJV;PRS;PL	be|zwer|en
bezwijmen	V;SBJV;PRS;PL	be|zwijm|en
bibberen	V;SBJV;PRS;PL	bibber|en
bibber	V;IND;PRS;1;SG	bibber
biechten	V;SBJV;PRS;PL	biecht|en
biecht	V;IND;PRS;3;SG	biecht
bijbehorend	ADJ;INDF;NEUT;SG	bij|behorend
bijgelovig	ADJ;INDF;NEUT;SG	bij|gelov|ig
bijgenaamd	ADJ;INDF;NEUT;SG	bij|genaamd
bijkomstig	ADJ;INDF;NEUT;SG	bij|kom|st|ig
bijtijds	ADJ;INDF;NEUT;SG	bij|tijd|s
bijvoeglijk	ADJ;INDF;NEUT;SG	bij|voeg|lijk
bijwoordelijk	ADJ;INDF;NEUT;SG	bij|woord|elijk
bikken	V;SBJV;PRS;PL	bikk|en
bik	V;IND;PRS;1;SG	bik
binnenlands	ADJ;INDF;NEUT;SG	binnen|land|s
biseksueel	ADJ;INDF;NEUT;SG	bi|seks|ueel
bisschoppelijk	ADJ;INDF;NEUT;SG	bisschopp|elijk
bits	ADJ;INDF;NEUT;SG	bits
bitteren	V;SBJV;PRS;PL	bitter|en
bitter	V;IND;PRS;1;SG	bitter
bizar	ADJ;INDF;NEUT;SG	bizar
bladverliezend	ADJ;INDF;NEUT;SG	blad|verliez|end
blaken	V;SBJV;PRS;PL	blak|en
blaker	V;IND;PRS;1;SG	blak|er
blank	ADJ;INDF;NEUT;SG	blank
blasfemeren	V;SBJV;PRS;PL	blasfem|er|en
blauwogig	ADJ;INDF;NEUT;SG	blauw|og|ig
blijf	V;IND;PRS;1;SG	blijf
blijven	V;SBJV;PRS;PL	blijven
bliksemen	V;SBJV;PRS;PL	bliksem|en
bliksem	V;IND;PRS;1;SG	bliksem
blinken	V;SBJV;PRS;PL	blink|en
blink	V;IND;PRS;1;SG	blink
bloeddorstig	ADJ;INDF;NEUT;SG	bloed|dorst|ig
bloeden	V;SBJV;PRS;PL	bloed|en
bloed	V;IND;PRS;1;SG	bloed
bloederig	ADJ;INDF;NEUT;SG	bloed|erig
bloedig	ADJ;INDF;NEUT;SG	bloed|ig
blokken	V;SBJV;PRS;PL	blokk|en
blok	V;IND;PRS;1;SG	blok
geblokt	V.PTCP;PST	ge|blok|t
blokkeren	V;SBJV;PRS;PL	blok|ker|en
blond	ADJ;INDF;NEUT;SG	blond
blootvoets	ADJ;INDF;NEUT;SG	bloot|voet|s
blozen	V;SBJV;PRS;PL	blozen
blunderen	V;SBJV;PRS;PL	blunder|en
blunder	V;IND;PRS;1;SG	blunder
blussen	V;SBJV;PRS;PL	bluss|en
blut	ADJ;INDF;NEUT;SG	blut
bodemloos	ADJ;INDF;NEUT;SG	bodem|loos
boeken	V;SBJV;PRS;PL	boek|en
boek	V;IND;PRS;1;SG	boek
boerde	V;SBJV;PST;SG	boerde
boeren	V;SBJV;PRS;PL	boer|en
boert	V;IND;PRS;3;SG	boert
boer	V;IND;PRS;1;SG	boer
boeten	V;SBJV;PRS;PL	boet|en
boete	V;SBJV;PRS;SG	boete
boetseren	V;SBJV;PRS;PL	boetser|en
boffen	V;SBJV;PRS;PL	boff|en
bof	V;IND;PRS;1;SG	bof
bogen	V;SBJV;PRS;PL	bog|en
boog	V;IND;PRS;1;SG	boog
bolrond	ADJ;INDF;NEUT;SG	bol|rond
bolvormig	ADJ;INDF;NEUT;SG	bol|vorm|ig
bondig	ADJ;INDF;NEUT;SG	bond|ig
bonken	V;SBJV;PRS;PL	bonk|en
bonk	V;IND;PRS;1;SG	bonk
bont	ADJ;INDF;NEUT;SG	bont
boosaardig	ADJ;INDF;NEUT;SG	boos|aard|ig
boos	ADJ;INDF;NEUT;SG	boos
borduren	V;SBJV;PRS;PL	bordur|en
boorden	V;SBJV;PST;PL	boord|en
boort	V;IND;PRS;3;SG	boort
boor	V;IND;PRS;1;SG	boor
boren	V;SBJV;PRS;PL	bor|en
borgen	V;SBJV;PRS;PL	borg|en
borg	V;IND;PRS;1;SG	borg
borstelen	V;SBJV;PRS;PL	borstel|en
borstel	V;IND;PRS;1;SG	borstel
borstelig	ADJ;INDF;NEUT;SG	borstel|ig
botsen	V;SBJV;PRS;PL	bots|en
bots	V;IND;PRS;1;SG	bots
boud	ADJ;INDF;NEUT;SG	boud
bouwvallig	ADJ;INDF;NEUT;SG	bouw|vall|ig
bovengistend	ADJ;INDF;NEUT;SG	boven|gist|end
bovennatuurlijk	ADJ;INDF;NEUT;SG	boven|natuur|lijk
bovenstaand	ADJ;INDF;NEUT;SG	boven|staand
bovenvermeld	ADJ;INDF;NEUT;SG	boven|vermeld
bovenwinds	ADJ;INDF;NEUT;SG	boven|wind|s
boycotten	V;SBJV;PST;PL	boycott|en
boycot	V;IND;PRS;3;SG	boycot
braaf	ADJ;INDF;NEUT;SG	braaf
braai	V;IND;PRS;1;SG	braai
braden	V;SBJV;PRS;PL	brad|en
brak	ADJ;INDF;NEUT;SG	brak
braak	V;IND;PRS;1;SG	braak
braken	V;SBJV;PRS;PL	brak|en
brandbaar	ADJ;INDF;NEUT;SG	brand|baar
brandschilderen	V;SBJV;PRS;PL	brand|schilder|en
breed	ADJ;INDF;NEUT;SG	breed
breekbaar	ADJ;INDF;NEUT;SG	breek|baar
breien	V;SBJV;PRS;PL	brei|en
brei	V;IND;PRS;1;SG	brei
brengen	V;SBJV;PRS;PL	breng|en
briesen	V;SBJV;PRS;PL	bries|en
bries	V;IND;PRS;1;SG	bries
broeden	V;SBJV;PRS;PL	broed|en
broed	V;IND;PRS;1;SG	broed
gebroed	V.PTCP;PST	ge|broed
brons	V;IND;PRS;1;SG	brons
bronzen	V;SBJV;PRS;PL	bronzen
broodmager	ADJ;INDF;NEUT;SG	brood|mager
bros	ADJ;INDF;NEUT;SG	bros
bruikbaar	ADJ;INDF;NEUT;SG	bruik|baar
bruinachtig	ADJ;INDF;NEUT;SG	bruin|achtig
bruisen	V;SBJV;PRS;PL	bruis|en
bruis	V;IND;PRS;1;SG	bruis
brullen	V;SBJV;PRS;PL	brull|en
brutaal	ADJ;INDF;NEUT;SG	brut|aal
bruusk	ADJ;INDF;NEUT;SG	bruusk
bruut	ADJ;INDF;NEUT;SG	bruut
buigzaam	ADJ;INDF;NEUT;SG	buig|zaam
buiig	ADJ;INDF;NEUT;SG	bui|ig
buitelen	V;SBJV;PRS;PL	buitel|en
buitenaards	ADJ;INDF;NEUT;SG	buiten|aard|s
buitenechtelijk	ADJ;INDF;NEUT;SG	buiten|echt|elijk
buitengaats	ADJ;INDF;NEUT;SG	buiten|gaat|s
buitengewoon	ADJ;INDF;NEUT;SG	buiten|gewoon
buitenlands	ADJ;INDF;NEUT;SG	buiten|land|s
buis	V;IND;PRS;1;SG	buis
buizen	V;SBJV;PRS;PL	buizen
bukken	V;SBJV;PRS;PL	bukk|en
bulderen	V;SBJV;PRS;PL	bulder|en
bungelen	V;SBJV;PRS;PL	bungel|en
burgerlijk	ADJ;INDF;NEUT;SG	burger|lijk
buste	V;SBJV;PST;SG	buste
bus	V;IND;PRS;1;SG	bus
cast	V;IND;PRS;3;SG	cast
catastrofaal	ADJ;INDF;NEUT;SG	catastrof|aal
categoriseren	V;SBJV;PRS;PL	categor|iser|en
cederen	V;SBJV;PRS;PL	ced|er|en
censureren	V;SBJV;PRS;PL	censur|er|en
centraal	ADJ;INDF;NEUT;SG	centr|aal
centrale	ADJ;INDF;PL	centr|al|e
centraliseren	V;SBJV;PRS;PL	centr|al|iser|en
centrifugaal	ADJ;INDF;NEUT;SG	centrifug|aal
centrifugeren	V;SBJV;PRS;PL	centrifug|er|en
chagrijnig	ADJ;INDF;NEUT;SG	chagrijn|ig
chaotisch	ADJ;INDF;NEUT;SG	chaot|isch
charismatisch	ADJ;INDF;NEUT;SG	charism|atisch
checken	V;SBJV;PRS;PL	check|en
choqueren	V;SBJV;PRS;PL	choq|uer|en
christelijk	ADJ;INDF;NEUT;SG	christ|elijk
cilindrisch	ADJ;INDF;NEUT;SG	cilindr|isch
claimen	V;SBJV;PRS;PL	claim|en
claim	V;IND;PRS;1;SG	claim
climacterisch	ADJ;INDF;NEUT;SG	climacter|isch
coderen	V;SBJV;PRS;PL	cod|er|en
collectiviseren	V;SBJV;PRS;PL	collectiv|iser|en
commercieel	ADJ;INDF;NEUT;SG	commerc|ieel
communistisch	ADJ;INDF;NEUT;SG	communist|isch
condenseren	V;SBJV;PRS;PL	condens|er|en
conflictueus	ADJ;INDF;NEUT;SG	conflict|ueus
congruent	ADJ;INDF;NEUT;SG	congru|ent
conisch	ADJ;INDF;NEUT;SG	con|isch
conservatief	ADJ;INDF;NEUT;SG	conserv|at|ief
constateren	V;SBJV;PRS;PL	constater|en
constitutioneel	ADJ;INDF;NEUT;SG	constitu|t|ioneel
constructief	ADJ;INDF;NEUT;SG	construct|ief
consumeren	V;SBJV;PRS;PL	consumer|en
continu	ADJ;INDF;NEUT;SG	continu
controversieel	ADJ;INDF;NEUT;SG	controvers|ieel
conventioneel	ADJ;INDF;NEUT;SG	convent|ioneel
crashen	V;SBJV;PRS;PL	crash|en
crash	V;IND;PRS;1;SG	crash
creatief	ADJ;INDF;NEUT;SG	cre|at|ief
cultureel	ADJ;INDF;NEUT;SG	cultur|eel
cumulatief	ADJ;INDF;NEUT;SG	cumul|at|ief
dagelijks	ADJ;INDF;NEUT;SG	dag|elijks
dakloos	ADJ;INDF;NEUT;SG	dak|loos
dalen	V;SBJV;PRS;PL	dal|en
damasten	ADJ;INDF;PL	damast|en
dampen	V;SBJV;PRS;PL	damp|en
damp	V;IND;PRS;1;SG	damp
danken	V;SBJV;PRS;PL	dank|en
dank	V;IND;PRS;1;SG	dank
dansen	V;SBJV;PRS;PL	dans|en
dans	V;IND;PRS;1;SG	dans
dapper	ADJ;INDF;NEUT;SG	dapper
dartelen	V;SBJV;PRS;PL	dartel|en
dartel	V;IND;PRS;1;SG	dartel
daveren	V;SBJV;PRS;PL	daver|en
daver	V;IND;PRS;1;SG	daver
debatteren	V;SBJV;PRS;PL	debat|ter|en
debuteren	V;SBJV;PRS;PL	debut|er|en
decentraliseren	V;SBJV;PRS;PL	de|centr|al|iser|en
decoderen	V;SBJV;PRS;PL	de|cod|er|en
decoratief	ADJ;INDF;NEUT;SG	decor|at|ief
deelbaar	ADJ;INDF;NEUT;SG	deel|baar
deerniswekkend	ADJ;INDF;NEUT;SG	deer|nis|wekk|end
defensief	ADJ;INDF;NEUT;SG	defens|ief
deinen	V;SBJV;PRS;PL	deinen
dekken	V;SBJV;PRS;PL	dekk|en
dek	V;IND;PRS;1;SG	dek
delgen	V;SBJV;PRS;PL	delg|en
delven	V;SBJV;PRS;PL	delven
demagogisch	ADJ;INDF;NEUT;SG	demagog|isch
demissionair	ADJ;INDF;NEUT;SG	demiss|ionair
democratisch	ADJ;INDF;NEUT;SG	democrat|isch
demonstratief	ADJ;INDF;NEUT;SG	demonstr|at|ief
demonteerbaar	ADJ;INDF;NEUT;SG	de|monteer|baar
demotiveren	V;SBJV;PRS;PL	de|motiv|er|en
dempen	V;SBJV;PRS;PL	demp|en
denderen	V;SBJV;PRS;PL	dender|en
denkbaar	ADJ;INDF;NEUT;SG	denk|baar
denkbeeldig	ADJ;INDF;NEUT;SG	denk|beeld|ig
denken	V;SBJV;PRS;PL	denk|en
depressief	ADJ;INDF;NEUT;SG	depress|ief
deren	V;SBJV;PRS;PL	der|en
deskundig	ADJ;INDF;NEUT;SG	des|kund|ig
deugdelijk	ADJ;INDF;NEUT;SG	deugd|elijk
deugdzaam	ADJ;INDF;NEUT;SG	deugd|zaam
dichtbij	ADJ;INDF;NEUT;SG	dicht|bij
dicht	ADJ;INDF;NEUT;SG	dicht
dichter	ADJ;INDF;PL;CMPR	dicht|er
dichtstbijzijnd	ADJ;INDF;NEUT;SG	dichtstbij|zijnd
dienen	V;SBJV;PRS;PL	dienen
dienstig	ADJ;INDF;NEUT;SG	dien|st|ig
dienstplichtig	ADJ;INDF;NEUT;SG	dien|st|plicht|ig
diepzinnig	ADJ;INDF;NEUT;SG	diep|zinn|ig
dierlijk	ADJ;INDF;NEUT;SG	dier|lijk
digestief	ADJ;INDF;NEUT;SG	digest|ief
digitaliseren	V;SBJV;PRS;PL	digital|iser|en
dik	ADJ;INDF;NEUT;SG	dik
dilettantisch	ADJ;INDF;NEUT;SG	dilettant|isch
dimensionaal	ADJ;INDF;NEUT;SG	dimens|ionaal
dimmen	V;SBJV;PRS;PL	dimm|en
diplomatiek	ADJ;INDF;NEUT;SG	diplomat|iek
disputeren	V;SBJV;PRS;PL	disput|er|en
gedistilleerd	V.PTCP;PST	gedistilleerd
documenteren	V;SBJV;PRS;PL	document|er|en
dodelijk	ADJ;INDF;NEUT;SG	dod|elijk
doden	V;SBJV;PRS;PL	dod|en
dood	V;IND;PRS;1;SG	dood
doelbewust	ADJ;INDF;NEUT;SG	doel|bewust
doelloos	ADJ;INDF;NEUT;SG	doel|loos
doelmatig	ADJ;INDF;NEUT;SG	doel|matig
doeltreffend	ADJ;INDF;NEUT;SG	doel|treff|end
doezelen	V;SBJV;PRS;PL	doezel|en
doezel	V;IND;PRS;1;SG	doezel
dof	ADJ;INDF;NEUT;SG	dof
dolen	V;SBJV;PRS;PL	dol|en
dool	V;IND;PRS;1;SG	dool
dolk	V;IND;PRS;1;SG	dolk
dominant	ADJ;INDF;NEUT;SG	domin|ant
dommelen	V;SBJV;PRS;PL	dommel|en
dommel	V;IND;PRS;1;SG	dommel
donderen	V;SBJV;PRS;PL	donder|en
donder	V;IND;PRS;1;SG	donder
donkerblauw	ADJ;INDF;NEUT;SG	donker|blauw
donkerbruin	ADJ;INDF;NEUT;SG	donker|bruin
donker	ADJ;INDF;NEUT;SG	donker
donkergeel	ADJ;INDF;NEUT;SG	donker|geel
donkergrijs	ADJ;INDF;NEUT;SG	donker|grijs
donkergroen	ADJ;INDF;NEUT;SG	donker|groen
donkerrood	ADJ;INDF;NEUT;SG	donker|rood
doodeenvoudig	ADJ;INDF;NEUT;SG	dood|eenvoud|ig
doodeng	ADJ;INDF;NEUT;SG	dood|eng
doodgeboren	ADJ;INDF;PL	dood|geboren
doodkalm	ADJ;INDF;NEUT;SG	dood|kalm
doodsbang	ADJ;INDF;NEUT;SG	dood|s|bang
doodziek	ADJ;INDF;NEUT;SG	dood|ziek
doof	V;IND;PRS;1;SG	doof
dooien	V;SBJV;PRS;PL	dooi|en
dooi	V;IND;PRS;1;SG	dooi
doorgronden	V;SBJV;PRS;PL	door|grond|en
doorslaggevend	ADJ;INDF;NEUT;SG	doorslag|gev|end
doorwaadbaar	ADJ;INDF;NEUT;SG	door|waad|baar
doorzichtig	ADJ;INDF;NEUT;SG	door|zi|chtig
doppen	V;SBJV;PRS;PL	dopp|en
dop	V;IND;PRS;1;SG	dop
dor	ADJ;INDF;NEUT;SG	dor
dorsen	V;SBJV;PRS;PL	dors|en
dorsten	V;SBJV;PRS;PL	dorst|en
dorst	V;IND;PRS;3;SG	dorst
dors	V;IND;PRS;1;SG	dors
dorstig	ADJ;INDF;NEUT;SG	dorst|ig
doseren	V;SBJV;PRS;PL	dos|er|en
douchen	V;SBJV;PRS;PL	douch|en
douche	V;SBJV;PRS;SG	douche
douwen	V;SBJV;PRS;PL	douw|en
douw	V;IND;PRS;1;SG	douw
doven	V;SBJV;PRS;PL	doven
draadloos	ADJ;INDF;NEUT;SG	draad|loos
draaglijk	ADJ;INDF;NEUT;SG	draag|lijk
draaien	V;SBJV;PRS;PL	draai|en
draai	V;IND;PRS;1;SG	draai
draaierig	ADJ;INDF;NEUT;SG	draai|erig
dragen	V;SBJV;PRS;PL	drag|en
dralen	V;SBJV;PRS;PL	dral|en
dramatisch	ADJ;INDF;NEUT;SG	dram|atisch
drammen	V;SBJV;PRS;PL	dramm|en
drammerig	ADJ;INDF;NEUT;SG	dramm|erig
dras	ADJ;INDF;NEUT;SG	dras
drassig	ADJ;INDF;NEUT;SG	drass|ig
dreigen	V;SBJV;PRS;PL	dreig|en
drenken	V;SBJV;PRS;PL	drenk|en
dreunen	V;SBJV;PRS;PL	dreunen
dreun	V;IND;PRS;1;SG	dreun
driedimensionaal	ADJ;INDF;NEUT;SG	drie|dimens|ionaal
driehoekig	ADJ;INDF;NEUT;SG	drie|hoek|ig
driekwart	ADJ;INDF;NEUT;SG	drie|kwart
driest	ADJ;INDF;NEUT;SG	driest
drievoudig	ADJ;INDF;NEUT;SG	drievoud|ig
driftig	ADJ;INDF;NEUT;SG	drift|ig
dreef	V;IND;PST;3;SG	dreef
drijven	V;SBJV;PRS;PL	drijven
dringen	V;SBJV;PRS;PL	dring|en
drinkbaar	ADJ;INDF;NEUT;SG	drink|baar
drinken	V;SBJV;PRS;PL	drink|en
dronk	V;IND;PST;3;SG	dronk
droef	ADJ;INDF;NEUT;SG	droef
droevig	ADJ;INDF;NEUT;SG	droev|ig
drogen	V;SBJV;PRS;PL	drog|en
droog	V;IND;PRS;1;SG	droog
dromen	V;SBJV;PRS;PL	drom|en
droom	V;IND;PRS;1;SG	droom
droop	V;IND;PST;3;SG	droop
druipen	V;SBJV;PRS;PL	druip|en
dubbel	ADJ;INDF;NEUT;SG	dubbel
duelleren	V;SBJV;PRS;PL	duel|ler|en
duf	ADJ;INDF;NEUT;SG	duf
duidelijk	ADJ;INDF;NEUT;SG	duid|elijk
duiden	V;SBJV;PRS;PL	duid|en
dook	V;IND;PST;3;SG	dook
duiken	V;SBJV;PRS;PL	duik|en
duik	V;IND;PRS;1;SG	duik
duimen	V;SBJV;PRS;PL	duim|en
duim	V;IND;PRS;1;SG	duim
duister	ADJ;INDF;NEUT;SG	duister
duivelachtig	ADJ;INDF;NEUT;SG	duivel|achtig
duivels	ADJ;INDF;NEUT;SG	duivel|s
duizelen	V;SBJV;PRS;PL	duizel|en
duizelig	ADJ;INDF;NEUT;SG	duizel|ig
duizelingwekkend	ADJ;INDF;NEUT;SG	duizel|ing|wekk|end
dumpen	V;SBJV;PRS;PL	dump|en
dump	V;IND;PRS;1;SG	dump
dun	V;IND;PRS;1;SG	dun
dunnen	V;SBJV;PRS;PL	dunnen
duren	V;SBJV;PRS;PL	dur|en
duur	V;IND;PRS;1;SG	duur
dutten	V;SBJV;PST;PL	dutt|en
dut	V;IND;PRS;3;SG	dut
duurzaam	ADJ;INDF;NEUT;SG	duur|zaam
duwen	V;SBJV;PRS;PL	duw|en
duw	V;IND;PRS;1;SG	duw
dwaas	ADJ;INDF;NEUT;SG	dwaas
dwaal	V;IND;PRS;1;SG	dwaal
dwalen	V;SBJV;PRS;PL	dwal|en
dwangmatig	ADJ;INDF;NEUT;SG	dwang|matig
dwarrelen	V;SBJV;PRS;PL	dwarrel|en
dwars	ADJ;INDF;NEUT;SG	dwars
dwarste	ADJ;INDF;PL;SPRL	dwars|te
dweilen	V;SBJV;PRS;PL	dweil|en
dweil	V;IND;PRS;1;SG	dweil
dweperig	ADJ;INDF;NEUT;SG	dwep|erig
dwingen	V;SBJV;PRS;PL	dwing|en
dwingerig	ADJ;INDF;NEUT;SG	dwing|erig
ebben	V;SBJV;PRS;PL	ebb|en
ebbe	V;SBJV;PRS;SG	ebbe
eb	V;IND;PRS;1;SG	eb
echo	V;IND;PRS;1;SG	echo
echt	ADJ;INDF;NEUT;SG	echt
echter	ADJ;INDF;PL;CMPR	echter
edel	ADJ;INDF;NEUT;SG	edel
edele	ADJ;INDF;PL	edel|e
eenarmig	ADJ;INDF;NEUT;SG	een|arm|ig
eenduidig	ADJ;INDF;NEUT;SG	een|duid|ig
eeneiig	ADJ;INDF;NEUT;SG	een|ei|ig
eenlettergrepig	ADJ;INDF;NEUT;SG	een|lettergrep|ig
eentonig	ADJ;INDF;NEUT;SG	een|ton|ig
eenvormig	ADJ;INDF;NEUT;SG	een|vorm|ig
eenvoudig	ADJ;INDF;NEUT;SG	eenvoud|ig
eenzaadlobbig	ADJ;INDF;NEUT;SG	een|zaad|lobb|ig
eenzaam	ADJ;INDF;NEUT;SG	een|zaam
eenzijdig	ADJ;INDF;NEUT;SG	een|zijd|ig
eerbiedig	ADJ;INDF;NEUT;SG	eerbied|ig
eerlijk	ADJ;INDF;NEUT;SG	eer|lijk
eerloos	ADJ;INDF;NEUT;SG	eer|loos
eerstgenoemd	ADJ;INDF;NEUT;SG	eer|st|genoemd
eervol	ADJ;INDF;NEUT;SG	eer|vol
eerzuchtig	ADJ;INDF;NEUT;SG	eer|zucht|ig
eetbaar	ADJ;INDF;NEUT;SG	eet|baar
eeuwig	ADJ;INDF;NEUT;SG	eeuw|ig
effectueren	V;SBJV;PRS;PL	effect|uer|en
effen	ADJ;INDF;PL	effen
eggen	V;SBJV;PRS;PL	egg|en
egge	V;SBJV;PRS;SG	egge
eg	V;IND;PRS;1;SG	eg
eigenaardig	ADJ;INDF;NEUT;SG	eigen|aard|ig
eigenen	V;SBJV;PRS;PL	eigenen
eigene	V;SBJV;PRS;SG	eigen|e
eigen	V;IND;PRS;1;SG	eigen
eigenhandig	ADJ;INDF;NEUT;SG	eigen|hand|ig
eigenlijk	ADJ;INDF;NEUT;SG	eigen|lijk
eigentijds	ADJ;INDF;NEUT;SG	eigen|tijd|s
eigenzinnig	ADJ;INDF;NEUT;SG	eigen|zinn|ig
eiken	ADJ;INDF;PL	eik|en
eindeloos	ADJ;INDF;NEUT;SG	eind|eloos
eindig	V;IND;PRS;1;SG	eind|ig
eisen	V;SBJV;PRS;PL	eis|en
eis	V;IND;PRS;1;SG	eis
eivormig	ADJ;INDF;NEUT;SG	ei|vorm|ig
elegant	ADJ;INDF;NEUT;SG	elegant
elektromagnetisch	ADJ;INDF;NEUT;SG	elektro|magnet|isch
elektronisch	ADJ;INDF;NEUT;SG	elektron|isch
elektrostatisch	ADJ;INDF;NEUT;SG	elektro|statisch
ellendig	ADJ;INDF;NEUT;SG	ellend|ig
ellenlang	ADJ;INDF;NEUT;SG	ell|en|lang
elliptisch	ADJ;INDF;NEUT;SG	ellipt|isch
embryonaal	ADJ;INDF;NEUT;SG	embry|onaal
emfatisch	ADJ;INDF;NEUT;SG	emfa|tisch
emmeren	V;SBJV;PRS;PL	emmer|en
emmer	V;IND;PRS;1;SG	emmer
emotioneel	ADJ;INDF;NEUT;SG	emot|ioneel
engelachtig	ADJ;INDF;NEUT;SG	engel|achtig
eng	ADJ;INDF;NEUT;SG	eng
enkelvoudig	ADJ;INDF;NEUT;SG	enkelvoud|ig
enorm	ADJ;INDF;NEUT;SG	enorm
enten	V;SBJV;PRS;PL	ent|en
ent	V;IND;PRS;3;SG	ent
enthousiast	ADJ;INDF;NEUT;SG	enthousiast
erbarmelijk	ADJ;INDF;NEUT;SG	erbarm|elijk
erfelijk	ADJ;INDF;NEUT;SG	erf|elijk
erg	ADJ;INDF;NEUT;SG	erg
ergerlijk	ADJ;INDF;NEUT;SG	erger|lijk
ernstig	ADJ;INDF;NEUT;SG	ernst|ig
escorteren	V;SBJV;PRS;PL	escort|er|en
essentieel	ADJ;INDF;NEUT;SG	essent|ieel
etherisch	ADJ;INDF;NEUT;SG	ether|isch
etterig	ADJ;INDF;NEUT;SG	etter|ig
euvel	ADJ;INDF;NEUT;SG	euvel
evangelisch	ADJ;INDF;NEUT;SG	evangel|isch
evasief	ADJ;INDF;NEUT;SG	evas|ief
even	ADJ;INDF;PL	even
evenwichtig	ADJ;INDF;NEUT;SG	even|wicht|ig
evenwijdig	ADJ;INDF;NEUT;SG	even|wijd|ig
excellent	ADJ;INDF;NEUT;SG	excell|ent
excentriek	ADJ;INDF;NEUT;SG	excentr|iek
exceptioneel	ADJ;INDF;NEUT;SG	except|ioneel
excessief	ADJ;INDF;NEUT;SG	excess|ief
exclusief	ADJ;INDF;NEUT;SG	exclus|ief
excuseren	V;SBJV;PRS;PL	excus|er|en
executief	ADJ;INDF;NEUT;SG	execut|ief
expansief	ADJ;INDF;NEUT;SG	expans|ief
experimenteren	V;SBJV;PRS;PL	experiment|er|en
explosief	ADJ;INDF;NEUT;SG	explos|ief
exporteren	V;SBJV;PRS;PL	export|er|en
expressionistisch	ADJ;INDF;NEUT;SG	expressionist|isch
ezelachtig	ADJ;INDF;NEUT;SG	ezel|achtig
fabelachtig	ADJ;INDF;NEUT;SG	fabel|achtig
factureren	V;SBJV;PRS;PL	factur|er|en
faal	V;IND;PRS;1;SG	faal
falen	V;SBJV;PRS;PL	fal|en
faseren	V;SBJV;PRS;PL	fas|er|en
fataal	ADJ;INDF;NEUT;SG	fat|aal
fatsoenlijk	ADJ;INDF;NEUT;SG	fatsoen|lijk
favoriete	ADJ;INDF;PL	favoriet|e
faxen	V;SBJV;PRS;PL	fax|en
federaliseren	V;SBJV;PRS;PL	federal|iser|en
feestelijk	ADJ;INDF;NEUT;SG	feest|elijk
feesten	V;SBJV;PRS;PL	feest|en
feest	V;IND;PRS;3;SG	feest
feilloos	ADJ;INDF;NEUT;SG	feil|loos
feitelijk	ADJ;INDF;NEUT;SG	feit|elijk
fel	ADJ;INDF;NEUT;SG	fel
fictief	ADJ;INDF;NEUT;SG	fict|ief
fier	ADJ;INDF;NEUT;SG	fier
fietsen	V;SBJV;PRS;PL	fiets|en
fiets	V;IND;PRS;1;SG	fiets
figuratief	ADJ;INDF;NEUT;SG	figur|at|ief
figuurlijk	ADJ;INDF;NEUT;SG	figuur|lijk
fijn	ADJ;INDF;NEUT;SG	fijn
fijne	ADJ;INDF;PL	fijn|e
fijngevoelig	ADJ;INDF;NEUT;SG	fijn|ge|voel|ig
fikken	V;SBJV;PRS;PL	fikk|en
fik	V;IND;PRS;1;SG	fik
fiksen	V;SBJV;PRS;PL	fiks|en
fiks	ADJ;INDF;NEUT;SG	fiks
financieel	ADJ;INDF;NEUT;SG	financ|ieel
fit	ADJ;INDF;NEUT;SG	fit
fitter	ADJ;INDF;PL;CMPR	fitt|er
fix	V;IND;PRS;1;SG	fix
fladderen	V;SBJV;PRS;PL	fladder|en
flanellen	ADJ;INDF;PL	flanell|en
flauw	ADJ;INDF;NEUT;SG	flauw
flessen	V;SBJV;PRS;PL	fless|en
fles	V;IND;PRS;1;SG	fles
fleurig	ADJ;INDF;NEUT;SG	fleur|ig
flikken	V;SBJV;PRS;PL	flikk|en
flik	V;IND;PRS;1;SG	flik
flikkeren	V;SBJV;PRS;PL	flikker|en
flikker	V;IND;PRS;1;SG	flikk|er
flink	ADJ;INDF;NEUT;SG	flink
flippen	V;SBJV;PRS;PL	flipp|en
flip	V;IND;PRS;1;SG	flip
flirten	V;SBJV;PRS;PL	flirt|en
flirt	V;IND;PRS;3;SG	flirt
flitsen	V;SBJV;PRS;PL	flits|en
flits	V;IND;PRS;1;SG	flits
floppen	V;SBJV;PRS;PL	flopp|en
flop	V;IND;PRS;1;SG	flop
fluisteren	V;SBJV;PRS;PL	fluister|en
fluiten	V;SBJV;PRS;PL	fluit|en
fluit	V;IND;PRS;3;SG	fluit
fluweelzacht	ADJ;INDF;NEUT;SG	fluweel|zacht
fluwelen	ADJ;INDF;PL	fluwel|en
foeteren	V;SBJV;PRS;PL	foeter|en
fokken	V;SBJV;PRS;PL	fokk|en
fok	V;IND;PRS;1;SG	fok
folteren	V;SBJV;PRS;PL	folter|en
fonkelen	V;SBJV;PRS;PL	fonkel|en
foppen	V;SBJV;PRS;PL	fopp|en
fop	V;IND;PRS;1;SG	fop
formaliseren	V;SBJV;PRS;PL	formal|iser|en
fors	ADJ;INDF;NEUT;SG	fors
fortuinlijk	ADJ;INDF;NEUT;SG	fortuin|lijk
foutief	ADJ;INDF;NEUT;SG	fout|ief
fraai	ADJ;INDF;NEUT;SG	fraai
franco	ADJ;INDF;PL	franco
friemelen	V;SBJV;PRS;PL	friemel|en
fris	ADJ;INDF;NEUT;SG	fris
friste	ADJ;INDF;PL;SPRL	fris|te
frunniken	V;SBJV;PRS;PL	frunnik|en
functioneren	V;SBJV;PRS;PL	funct|ioner|en
fundamenteel	ADJ;INDF;NEUT;SG	fundament|eel
futloos	ADJ;INDF;NEUT;SG	fut|loos
futuristisch	ADJ;INDF;NEUT;SG	futurist|isch
fysiek	ADJ;INDF;NEUT;SG	fys|iek
gaaf	ADJ;INDF;NEUT;SG	gaaf
gaafrandig	ADJ;INDF;NEUT;SG	gaaf|rand|ig
gaar	ADJ;INDF;NEUT;SG	gaar
gaarder	ADJ;INDF;PL;CMPR	gaar|der
gabardine	ADJ;INDF;PL	gabardine
galmen	V;SBJV;PRS;PL	galm|en
galm	V;IND;PRS;1;SG	galm
galopperen	V;SBJV;PRS;PL	galop|per|en
game	V;SBJV;PRS;SG	game
gammel	ADJ;INDF;NEUT;SG	gammel
gappen	V;SBJV;PRS;PL	gapp|en
gassen	V;SBJV;PRS;PL	gass|en
gast	V;IND;PRS;3;SG	gast
gas	V;IND;PRS;1;SG	gas
gastvrij	ADJ;INDF;NEUT;SG	gast|vrij
gasvormig	ADJ;INDF;NEUT;SG	gas|vorm|ig
gebrekkig	ADJ;INDF;NEUT;SG	gebrekk|ig
gebruikelijk	ADJ;INDF;NEUT;SG	gebruik|elijk
gedachteloos	ADJ;INDF;NEUT;SG	gedachte|loos
gedeeltelijk	ADJ;INDF;NEUT;SG	ge|deel|te|lijk
gedenkwaardig	ADJ;INDF;NEUT;SG	gedenk|waard|ig
geduldig	ADJ;INDF;NEUT;SG	geduld|ig
geelachtig	ADJ;INDF;NEUT;SG	geel|achtig
geelgroen	ADJ;INDF;NEUT;SG	geel|groen
geestdodend	ADJ;INDF;NEUT;SG	geest|dod|end
geestdriftig	ADJ;INDF;NEUT;SG	geest|drift|ig
geestelijk	ADJ;INDF;NEUT;SG	geest|elijk
geestig	ADJ;INDF;NEUT;SG	geest|ig
geheel	ADJ;INDF;NEUT;SG	ge|heel
geheimzinnig	ADJ;INDF;NEUT;SG	geheim|zinn|ig
geil	ADJ;INDF;NEUT;SG	geil
geinig	ADJ;INDF;NEUT;SG	gein|ig
gek	ADJ;INDF;NEUT;SG	gek
gelaarsd	V.PTCP;PST	ge|laars|d
gelden	V;SBJV;PRS;PL	geld|en
geld	V;IND;PRS;1;SG	geld
geldswaardig	ADJ;INDF;NEUT;SG	geld|s|waard|ig
geleidelijk	ADJ;INDF;NEUT;SG	ge|leid|elijk
geleiden	V;SBJV;PRS;PL	ge|leid|en
gelig	ADJ;INDF;NEUT;SG	gel|ig
gelijk	V;IND;PRS;1;SG	ge|lijk
gelijkmatig	ADJ;INDF;NEUT;SG	ge|lijk|matig
gelijknamig	ADJ;INDF;NEUT;SG	gelijk|nam|ig
gelijktijdig	ADJ;INDF;NEUT;SG	gelijk|tijd|ig
gelijkvloers	ADJ;INDF;NEUT;SG	gelijk|vloer|s
gelijkwaardig	ADJ;INDF;NEUT;SG	gelijk|waard|ig
gelijkwaardiger	ADJ;INDF;PL;CMPR	gelijk|waard|ig|er
gelijkzijdig	ADJ;INDF;NEUT;SG	gelijk|zijd|ig
gelovig	ADJ;INDF;NEUT;SG	gelov|ig
gelukkig	ADJ;INDF;NEUT;SG	ge|lukk|ig
gemakkelijk	ADJ;INDF;NEUT;SG	gemakk|elijk
gemeenschappelijk	ADJ;INDF;NEUT;SG	gemeen|schapp|elijk
gemeentelijk	ADJ;INDF;NEUT;SG	gemeente|lijk
gemeenzaam	ADJ;INDF;NEUT;SG	gemeen|zaam
gemoedelijk	ADJ;INDF;NEUT;SG	gemoed|elijk
genadeloos	ADJ;INDF;NEUT;SG	genade|loos
genadig	ADJ;INDF;NEUT;SG	genad|ig
genant	ADJ;INDF;NEUT;SG	gen|ant
geneeskrachtig	ADJ;INDF;NEUT;SG	genees|kracht|ig
geneeskundig	ADJ;INDF;NEUT;SG	genees|kund|ig
geneeslijk	ADJ;INDF;NEUT;SG	genees|lijk
generaliseren	V;SBJV;PRS;PL	general|iser|en
genetisch	ADJ;INDF;NEUT;SG	genet|isch
geniaal	ADJ;INDF;NEUT;SG	geni|aal
geniepig	ADJ;INDF;NEUT;SG	geniep|ig
gerechtelijk	ADJ;INDF;NEUT;SG	gerecht|elijk
gering	ADJ;INDF;NEUT;SG	gering
geruisloos	ADJ;INDF;NEUT;SG	ge|ruis|loos
geruit	ADJ;INDF;NEUT;SG	ge|ruit
geselen	V;SBJV;PRS;PL	gesel|en
gesel	V;IND;PRS;1;SG	gesel
gespen	V;SBJV;PRS;PL	gesp|en
gesp	V;IND;PRS;1;SG	gesp
gestreept	ADJ;INDF;NEUT;SG	ge|streep|t
getuig	V;IND;PRS;1;SG	ge|tuig
geuren	V;SBJV;PRS;PL	geur|en
geur	V;IND;PRS;1;SG	geur
geurig	ADJ;INDF;NEUT;SG	geur|ig
geus	ADJ;INDF;NEUT;SG	geus
gevaarlijk	ADJ;INDF;NEUT;SG	gevaar|lijk
gevleugeld	ADJ;INDF;NEUT;SG	ge|vleugel|d
gevoel	V;IND;PRS;1;SG	ge|voel
gevoelig	ADJ;INDF;NEUT;SG	ge|voel|ig
gewelddadig	ADJ;INDF;NEUT;SG	geweld|dad|ig
geweldloos	ADJ;INDF;NEUT;SG	geweld|loos
gewestelijk	ADJ;INDF;NEUT;SG	gewest|elijk
gewetenloos	ADJ;INDF;NEUT;SG	geweten|loos
gewoon	ADJ;INDF;NEUT;SG	gewoon
gewrocht	V.PTCP;PST	ge|wrocht
giechelen	V;SBJV;PRS;PL	giechel|en
giechel	V;IND;PRS;1;SG	giechel
gieren	V;SBJV;PRS;PL	gier|en
gier	V;IND;PRS;1;SG	gier
giftig	ADJ;INDF;NEUT;SG	gift|ig
gigantisch	ADJ;INDF;NEUT;SG	gigant|isch
gijzelen	V;SBJV;PRS;PL	gijzel|en
gipsen	ADJ;INDF;PL	gips|en
gisten	V;SBJV;PRS;PL	gist|en
gist	V;IND;PRS;3;SG	gist
glad	ADJ;INDF;NEUT;SG	glad
glans	V;IND;PRS;1;SG	glans
glanzen	V;SBJV;PRS;PL	glanzen
glasachtig	ADJ;INDF;NEUT;SG	glas|achtig
glashelder	ADJ;INDF;NEUT;SG	glas|helder
glijden	V;SBJV;PRS;PL	glijd|en
glimlachen	V;SBJV;PRS;PL	glim|lach|en
glimlach	V;IND;PRS;1;SG	glim|lach
glimmen	V;SBJV;PRS;PL	glimm|en
gloednieuw	ADJ;INDF;NEUT;SG	gloed|nieuw
gloeien	V;SBJV;PRS;PL	gloei|en
glooien	V;SBJV;PRS;PL	glooi|en
gluiperig	ADJ;INDF;NEUT;SG	gluip|erig
glunderen	V;SBJV;PRS;PL	glunder|en
glunder	V;IND;PRS;1;SG	glunder
gluren	V;SBJV;PRS;PL	glur|en
goddelijk	ADJ;INDF;NEUT;SG	godd|elijk
godsdienstig	ADJ;INDF;NEUT;SG	god|s|dien|st|ig
goedaardig	ADJ;INDF;NEUT;SG	goed|aard|ig
goed	V;IND;PRS;1;SG	goed
goedgeefs	ADJ;INDF;NEUT;SG	goed|geef|s
goedkoop	ADJ;INDF;NEUT;SG	goed|koop
goedlachs	ADJ;INDF;NEUT;SG	goed|lach|s
gojims	ADJ;INDF;NEUT;SG	gojim|s
gojs	ADJ;INDF;NEUT;SG	goj|s
gokken	V;SBJV;PRS;PL	gokk|en
gok	V;IND;PRS;1;SG	gok
golfen	V;SBJV;PRS;PL	golf|en
golf	V;IND;PRS;1;SG	golf
golven	V;SBJV;PRS;PL	golven
gons	V;IND;PRS;1;SG	gons
gonzen	V;SBJV;PRS;PL	gonzen
goochelen	V;SBJV;PRS;PL	goochel|en
goochem	ADJ;INDF;NEUT;SG	goochem
gooien	V;SBJV;PRS;PL	gooi|en
gooi	V;IND;PRS;1;SG	gooi
goor	ADJ;INDF;NEUT;SG	goor
gorgelen	V;SBJV;PRS;PL	gorgel|en
gorgel	V;IND;PRS;1;SG	gorgel
gortig	ADJ;INDF;NEUT;SG	gort|ig
goudblond	ADJ;INDF;NEUT;SG	goud|blond
graaien	V;SBJV;PRS;PL	graai|en
graai	V;IND;PRS;1;SG	graai
graatmager	ADJ;INDF;NEUT;SG	graat|mager
grammaticaal	ADJ;INDF;NEUT;SG	grammatic|aal
grasgroen	ADJ;INDF;NEUT;SG	gras|groen
grauw	ADJ;INDF;NEUT;SG	grauw
grazen	V;SBJV;PRS;PL	grazen
grendelen	V;SBJV;PRS;PL	grendel|en
grendel	V;IND;PRS;1;SG	grendel
grenzeloos	ADJ;INDF;NEUT;SG	grenz|eloos
grens	V;IND;PRS;1;SG	grens
grenzen	V;SBJV;PRS;PL	grenzen
grienen	V;SBJV;PRS;PL	grienen
griepachtig	ADJ;INDF;NEUT;SG	griep|achtig
griezelig	ADJ;INDF;NEUT;SG	griezel|ig
grijns	V;IND;PRS;1;SG	grijns
grijnzen	V;SBJV;PRS;PL	grijnzen
greep	V;IND;PST;3;SG	greep
grijpen	V;SBJV;PRS;PL	grijp|en
grijp	V;IND;PRS;1;SG	grijp
grijsachtig	ADJ;INDF;NEUT;SG	grijs|achtig
grijsharig	ADJ;INDF;NEUT;SG	grijs|har|ig
grijzig	ADJ;INDF;NEUT;SG	grijz|ig
grillig	ADJ;INDF;NEUT;SG	grill|ig
grimmig	ADJ;INDF;NEUT;SG	grimm|ig
grissen	V;SBJV;PRS;PL	griss|en
groenachtig	ADJ;INDF;NEUT;SG	groen|achtig
groenblijvend	ADJ;INDF;NEUT;SG	groen|blijv|end
groenig	ADJ;INDF;NEUT;SG	groen|ig
groeperen	V;SBJV;PRS;PL	groep|er|en
groepsgewijs	ADJ;INDF;NEUT;SG	groep|s|gewijs
groepsgewijze	ADJ;INDF;PL	groep|s|gewijze
groef	V;IND;PRS;1;SG	groef
groeven	V;SBJV;PRS;PL	groeven
grommen	V;SBJV;PRS;PL	gromm|en
grom	V;IND;PRS;1;SG	grom
grondig	ADJ;INDF;NEUT;SG	grond|ig
grootschalig	ADJ;INDF;NEUT;SG	groot|schal|ig
groots	ADJ;INDF;NEUT;SG	groot|s
gruwelijk	ADJ;INDF;NEUT;SG	gruw|elijk
gruwzaam	ADJ;INDF;NEUT;SG	gruw|zaam
gunnen	V;SBJV;PRS;PL	gunnen
gunstig	ADJ;INDF;NEUT;SG	gun|st|ig
gutsen	V;SBJV;PRS;PL	guts|en
guts	V;IND;PRS;1;SG	guts
guur	ADJ;INDF;NEUT;SG	guur
haaks	ADJ;INDF;NEUT;SG	haak|s
haalbaar	ADJ;INDF;NEUT;SG	haal|baar
haarscherp	ADJ;INDF;NEUT;SG	haar|scherp
gehaast	V.PTCP;PST	ge|haast
haasten	V;SBJV;PRS;PL	haast|en
haast	V;IND;PRS;3;SG	haast
haastig	ADJ;INDF;NEUT;SG	haast|ig
hagelen	V;SBJV;PRS;PL	hagel|en
hagel	V;IND;PRS;1;SG	hagel
haal	V;IND;PRS;1;SG	haal
halen	V;SBJV;PRS;PL	hal|en
half	ADJ;INDF;NEUT;SG	half
halfhartig	ADJ;INDF;NEUT;SG	half|hart|ig
halfnaakt	ADJ;INDF;NEUT;SG	half|naakt
halsstarrig	ADJ;INDF;NEUT;SG	hals|starr|ig
hameren	V;SBJV;PRS;PL	hamer|en
hamer	V;IND;PRS;1;SG	hamer
hamsteren	V;SBJV;PRS;PL	hamster|en
hamster	V;IND;PRS;1;SG	hamster
handelen	V;SBJV;PRS;PL	handel|en
handel	V;IND;PRS;1;SG	handel
hangen	V;SBJV;PRS;PL	hang|en
hang	V;IND;PRS;1;SG	hang
haperen	V;SBJV;PRS;PL	haper|en
happen	V;SBJV;PRS;PL	happ|en
hap	V;IND;PRS;1;SG	hap
harden	V;SBJV;PRS;PL	hard|en
hard	ADJ;INDF;NEUT;SG	hard
harder	ADJ;INDF;PL;CMPR	hard|er
hardnekkig	ADJ;INDF;NEUT;SG	hard|nekk|ig
harken	V;SBJV;PRS;PL	hark|en
hark	V;IND;PRS;1;SG	hark
harmoniseren	V;SBJV;PRS;PL	harmon|iser|en
harst	V;IND;PRS;3;SG	harst
harteloos	ADJ;INDF;NEUT;SG	hart|eloos
hartstochtelijk	ADJ;INDF;NEUT;SG	hart|s|tocht|elijk
hartvormig	ADJ;INDF;NEUT;SG	hart|vorm|ig
hatelijk	ADJ;INDF;NEUT;SG	hat|elijk
haat	V;IND;PRS;3;SG	haat
haten	V;SBJV;PRS;PL	hat|en
haveloos	ADJ;INDF;NEUT;SG	have|loos
hebben	V;SBJV;PRS;PL	hebb|en
heb	V;IND;PRS;1;SG	heb
heeft	V;IND;PRS;3;SG	heeft
hebzuchtig	ADJ;INDF;NEUT;SG	heb|zucht|ig
hechten	V;SBJV;PRS;PL	hecht|en
hecht	ADJ;INDF;NEUT;SG	hecht
hedendaags	ADJ;INDF;NEUT;SG	heden|daag|s
heel	ADJ;INDF;NEUT;SG	heel
heler	ADJ;INDF;PL;CMPR	hel|er
heerlijk	ADJ;INDF;NEUT;SG	heer|lijk
heersen	V;SBJV;PRS;PL	heers|en
hees	V;IND;PST;3;SG	hees
heetgebakerd	ADJ;INDF;NEUT;SG	heet|gebakerd
heffen	V;SBJV;PRS;PL	heff|en
heft	V;IND;PRS;3;SG	heft
hef	V;IND;PRS;1;SG	hef
heidens	ADJ;INDF;NEUT;SG	heiden|s
heldhaftig	ADJ;INDF;NEUT;SG	held|haftig
hellen	V;SBJV;PRS;PL	hell|en
hel	V;IND;PRS;1;SG	hel
helpen	V;SBJV;PRS;PL	help|en
hels	ADJ;INDF;NEUT;SG	hel|s
hemelblauw	ADJ;INDF;NEUT;SG	hemel|blauw
hemelhoog	ADJ;INDF;NEUT;SG	hemel|hoog
hemelsblauw	ADJ;INDF;NEUT;SG	hemel|s|blauw
hemels	ADJ;INDF;NEUT;SG	hemel|s
hengelen	V;SBJV;PRS;PL	hengel|en
hengel	V;IND;PRS;1;SG	hengel
herbergzaam	ADJ;INDF;NEUT;SG	herberg|zaam
herbouwen	V;SBJV;PRS;PL	her|bouw|en
herbouw	V;IND;PRS;1;SG	her|bouw
herdenken	V;SBJV;PRS;PL	her|denk|en
herenigen	V;SBJV;PRS;PL	her|enig|en
herformuleren	V;SBJV;PRS;PL	her|formuler|en
hergebruik	V;IND;PRS;1;SG	her|gebruik
hergroeperen	V;SBJV;PRS;PL	her|groep|er|en
herkansen	V;SBJV;PRS;PL	her|kans|en
herkenbaar	ADJ;INDF;NEUT;SG	her|ken|baar
herkennen	V;SBJV;PRS;PL	her|kennen
herkrijgen	V;SBJV;PRS;PL	her|krijg|en
herleven	V;SBJV;PRS;PL	her|leven
hernemen	V;SBJV;PRS;PL	her|nem|en
hernieuwen	V;SBJV;PRS;PL	her|nieuw|en
heropenen	V;SBJV;PRS;PL	her|openen
heroveren	V;SBJV;PRS;PL	her|over|en
hersenspoelen	V;SBJV;PRS;PL	hersen|spoel|en
hertogelijk	ADJ;INDF;NEUT;SG	hertog|elijk
hertrouwen	V;SBJV;PRS;PL	her|trouw|en
hertrouw	V;IND;PRS;1;SG	her|trouw
hervatten	V;SBJV;PST;PL	her|vatt|en
hervormen	V;SBJV;PRS;PL	her|vorm|en
herwinnen	V;SBJV;PRS;PL	her|winnen
heteroseksueel	ADJ;INDF;NEUT;SG	hetero|seks|ueel
heugen	V;SBJV;PRS;PL	heug|en
heug	V;IND;PRS;1;SG	heug
heulen	V;SBJV;PRS;PL	heul|en
heul	V;IND;PRS;1;SG	heul
heus	ADJ;INDF;NEUT;SG	heus
heuvelachtig	ADJ;INDF;NEUT;SG	heuvel|achtig
hexagonaal	ADJ;INDF;NEUT;SG	hexagon|aal
hijgen	V;SBJV;PRS;PL	hijg|en
hijsen	V;SBJV;PRS;PL	hijs|en
hijs	V;IND;PRS;1;SG	hijs
hinderen	V;SBJV;PRS;PL	hinder|en
hinder	V;IND;PRS;1;SG	hinder
hinken	V;SBJV;PRS;PL	hink|en
hinniken	V;SBJV;PRS;PL	hinnik|en
hinten	V;SBJV;PRS;PL	hint|en
hint	V;IND;PRS;3;SG	hint
hittebestendig	ADJ;INDF;NEUT;SG	hitte|bestendig
hoekig	ADJ;INDF;NEUT;SG	hoek|ig
hoeveelste	ADJ;INDF;PL	hoeveel|ste
hoffelijk	ADJ;INDF;NEUT;SG	hoff|elijk
hokken	V;SBJV;PRS;PL	hokk|en
hok	V;IND;PRS;1;SG	hok
homoseksueel	ADJ;INDF;NEUT;SG	homo|seks|ueel
hondachtig	ADJ;INDF;NEUT;SG	hond|achtig
hondsdol	ADJ;INDF;NEUT;SG	hond|s|dol
honds	ADJ;INDF;NEUT;SG	hond|s
hongeren	V;SBJV;PRS;PL	honger|en
honger	V;IND;PRS;1;SG	honger
hongerig	ADJ;INDF;NEUT;SG	honger|ig
hoofdrekenen	V;SBJV;PRS;PL	hoofd|rekenen
hoofdstedelijk	ADJ;INDF;NEUT;SG	hoofd|sted|elijk
hoofdzakelijk	ADJ;INDF;NEUT;SG	hoofd|zak|elijk
hooghartig	ADJ;INDF;NEUT;SG	hoog|hart|ig
hoogpolig	ADJ;INDF;NEUT;SG	hoog|pol|ig
hoopvol	ADJ;INDF;NEUT;SG	hoop|vol
hoorbaar	ADJ;INDF;NEUT;SG	hoor|baar
hopeloos	ADJ;INDF;NEUT;SG	hop|eloos
hoop	V;IND;PRS;1;SG	hoop
hopen	V;SBJV;PRS;PL	hop|en
hoor	V;IND;PRS;1;SG	hoor
horen	V;SBJV;PRS;PL	hor|en
horizontaal	ADJ;INDF;NEUT;SG	horizont|aal
hormonaal	ADJ;INDF;NEUT;SG	hormon|aal
hossen	V;SBJV;PRS;PL	hoss|en
houdbaar	ADJ;INDF;NEUT;SG	houd|baar
houtachtig	ADJ;INDF;NEUT;SG	hout|achtig
houterig	ADJ;INDF;NEUT;SG	hout|erig
houtig	ADJ;INDF;NEUT;SG	hout|ig
huichelen	V;SBJV;PRS;PL	huichel|en
huik	V;IND;PRS;1;SG	huik
huilebalk	V;IND;PRS;1;SG	huil|e|balk
huilen	V;SBJV;PRS;PL	huil|en
huiselijk	ADJ;INDF;NEUT;SG	huis|elijk
huisvesten	V;SBJV;PRS;PL	huis|vest|en
huiveren	V;SBJV;PRS;PL	huiver|en
huiveringwekkend	ADJ;INDF;NEUT;SG	huiver|ing|wekk|end
huis	V;IND;PRS;1;SG	huis
huizen	V;SBJV;PRS;PL	huizen
hullen	V;SBJV;PRS;PL	hull|en
hul	V;IND;PRS;1;SG	hul
hulpeloos	ADJ;INDF;NEUT;SG	hulp|eloos
humeurig	ADJ;INDF;NEUT;SG	humeur|ig
humoristisch	ADJ;INDF;NEUT;SG	humor|ist|isch
hunkeren	V;SBJV;PRS;PL	hunker|en
huppen	V;SBJV;PRS;PL	hupp|en
hup	V;IND;PRS;1;SG	hup
huren	V;SBJV;PRS;PL	hur|en
huur	V;IND;PRS;1;SG	huur
hurken	V;SBJV;PRS;PL	hurk|en
husselen	V;SBJV;PRS;PL	hussel|en
huwen	V;SBJV;PRS;PL	huw|en
hydrodynamisch	ADJ;INDF;NEUT;SG	hydro|dynamisch
hydrostatisch	ADJ;INDF;NEUT;SG	hydro|statisch
hypnotiseren	V;SBJV;PRS;PL	hypnot|iser|en
hypothetisch	ADJ;INDF;NEUT;SG	hypothet|isch
ideaal	ADJ;INDF;NEUT;SG	ide|aal
idealiseren	V;SBJV;PRS;PL	ide|al|iser|en
idioot	ADJ;INDF;NEUT;SG	idioot
iel	ADJ;INDF;NEUT;SG	iel
ignorant	ADJ;INDF;NEUT;SG	ignor|ant
ijdel	ADJ;INDF;NEUT;SG	ijdel
ijken	V;SBJV;PRS;PL	ijk|en
ijk	V;IND;PRS;1;SG	ijk
ijlhoofdig	ADJ;INDF;NEUT;SG	ijl|hoofd|ig
ijsbeer	V;IND;PRS;1;SG	ijs|beer
ijskoud	ADJ;INDF;NEUT;SG	ijs|koud
ijveren	V;SBJV;PRS;PL	ijver|en
ijver	V;IND;PRS;1;SG	ijver
ijzeren	ADJ;INDF;PL	ijzer|en
ijzingwekkend	ADJ;INDF;NEUT;SG	ijz|ing|wekk|end
illegaal	ADJ;INDF;NEUT;SG	il|legaal
impopulair	ADJ;INDF;NEUT;SG	im|populair
importeren	V;SBJV;PRS;PL	import|er|en
inactief	ADJ;INDF;NEUT;SG	in|act|ief
inbegrepen	ADJ;INDF;PL	in|begrepen
inclusief	ADJ;INDF;NEUT;SG	inclu|s|ief
incongruent	ADJ;INDF;NEUT;SG	in|congru|ent
indexeren	V;SBJV;PRS;PL	index|er|en
indicatief	ADJ;INDF;NEUT;SG	indic|at|ief
indiscreet	ADJ;INDF;NEUT;SG	in|discreet
indrukwekkend	ADJ;INDF;NEUT;SG	in|druk|wekk|end
industrialiseren	V;SBJV;PRS;PL	industr|ial|iser|en
industrieel	ADJ;INDF;NEUT;SG	industr|ieel
ineffectief	ADJ;INDF;NEUT;SG	in|effectief
infecteren	V;SBJV;PRS;PL	infect|er|en
informeel	ADJ;INDF;NEUT;SG	in|formeel
inhalig	ADJ;INDF;NEUT;SG	in|hal|ig
inheems	ADJ;INDF;NEUT;SG	in|heem|s
inhoudelijk	ADJ;INDF;NEUT;SG	inhoud|elijk
innen	V;SBJV;PRS;PL	innen
in	V;IND;PRS;1;SG	in
instabiel	ADJ;INDF;NEUT;SG	in|stabiel
intellectueel	ADJ;INDF;NEUT;SG	intellect|ueel
interdisciplinair	ADJ;INDF;NEUT;SG	inter|disciplin|air
interessant	ADJ;INDF;NEUT;SG	interess|ant
internationaal	ADJ;INDF;NEUT;SG	inter|nat|ionaal
interpretabel	ADJ;INDF;NEUT;SG	interpret|abel
intijds	ADJ;INDF;NEUT;SG	in|tijd|s
invalide	ADJ;INDF;PL	in|valide
invloedrijk	ADJ;INDF;NEUT;SG	invloed|rijk
ivoorkleurig	ADJ;INDF;NEUT;SG	ivoor|kleur|ig
ivoren	ADJ;INDF;PL	ivor|en
jaarlijks	ADJ;INDF;NEUT;SG	jaar|lijks
jachten	V;SBJV;PRS;PL	jacht|en
jacht	V;IND;PRS;3;SG	jacht
jaloers	ADJ;INDF;NEUT;SG	jaloers
jambisch	ADJ;INDF;NEUT;SG	jamb|isch
jammeren	V;SBJV;PRS;PL	jammer|en
jammer	ADJ;INDF;NEUT;SG	jammer
janken	V;SBJV;PRS;PL	jank|en
jarenlang	ADJ;INDF;NEUT;SG	jar|en|lang
jarig	ADJ;INDF;NEUT;SG	jar|ig
jassen	V;SBJV;PRS;PL	jass|en
jas	V;IND;PRS;1;SG	jas
jatten	V;SBJV;PST;PL	jatt|en
jat	V;IND;PRS;3;SG	jat
jeugdig	ADJ;INDF;NEUT;SG	jeugd|ig
jeuken	V;SBJV;PRS;PL	jeuk|en
jeukte	V;SBJV;PST;SG	jeuk|te
jeuk	V;IND;PRS;1;SG	jeuk
jichtig	ADJ;INDF;NEUT;SG	jicht|ig
jijen	V;SBJV;PRS;PL	jij|en
jij	V;IND;PRS;1;SG	jij
jodelen	V;SBJV;PRS;PL	jodel|en
joelen	V;SBJV;PRS;PL	joel|en
joggen	V;SBJV;PRS;PL	jogg|en
jolig	ADJ;INDF;NEUT;SG	jol|ig
jong	ADJ;INDF;NEUT;SG	jong
joods	ADJ;INDF;NEUT;SG	jood|s
jouen	V;SBJV;PRS;PL	jou|en
jou	V;IND;PRS;1;SG	jou
journalistiek	ADJ;INDF;NEUT;SG	journal|ist|i|ek
jubelen	V;SBJV;PRS;PL	jubel|en
jubel	V;IND;PRS;1;SG	jubel
juichen	V;SBJV;PRS;PL	juich|en
juist	ADJ;INDF;NEUT;SG	juist
kaal	ADJ;INDF;NEUT;SG	kaal
kaarden	V;SBJV;PRS;PL	kaard|en
kaard	V;IND;PRS;1;SG	kaard
kaarsrecht	ADJ;INDF;NEUT;SG	kaars|recht
kaarten	V;SBJV;PRS;PL	kaart|en
kaart	V;IND;PRS;3;SG	kaart
kaatsen	V;SBJV;PRS;PL	kaats|en
kaats	V;IND;PRS;1;SG	kaats
kabbelen	V;SBJV;PRS;PL	kabbel|en
kakken	V;SBJV;PRS;PL	kakk|en
kak	V;IND;PRS;1;SG	kak
kalken	V;SBJV;PRS;PL	kalk|en
kalk	V;IND;PRS;1;SG	kalk
kallen	V;SBJV;PRS;PL	kall|en
kalmeren	V;SBJV;PRS;PL	kalm|er|en
kalm	ADJ;INDF;NEUT;SG	kalm
kalf	V;IND;PRS;1;SG	kalf
kalven	V;SBJV;PRS;PL	kalven
gekamd	V.PTCP;PST	ge|kam|d
kammen	V;SBJV;PRS;PL	kamm|en
kam	V;IND;PRS;1;SG	kam
kampen	V;SBJV;PRS;PL	kamp|en
kamp	V;IND;PRS;1;SG	kamp
kamperen	V;SBJV;PRS;PL	kamp|er|en
kaan	V;IND;PRS;1;SG	kaan
kanen	V;SBJV;PRS;PL	kanen
kankeren	V;SBJV;PRS;PL	kanker|en
kanker	V;IND;PRS;1;SG	kanker
kansloos	ADJ;INDF;NEUT;SG	kans|loos
kapitalistisch	ADJ;INDF;NEUT;SG	kapital|ist|isch
kapot	ADJ;INDF;NEUT;SG	kapot
kardinaal	ADJ;INDF;NEUT;SG	kardinaal
karnen	V;SBJV;PRS;PL	karnen
karn	V;IND;PRS;1;SG	karn
kastijden	V;SBJV;PRS;PL	kastijd|en
katachtig	ADJ;INDF;NEUT;SG	kat|achtig
katholiek	ADJ;INDF;NEUT;SG	katholiek
katoenen	ADJ;INDF;PL	katoen|en
katten	V;SBJV;PST;PL	katt|en
kat	V;IND;PRS;3;SG	kat
keihard	ADJ;INDF;NEUT;SG	kei|hard
keizerlijk	ADJ;INDF;NEUT;SG	keizer|lijk
kelderen	V;SBJV;PRS;PL	kelder|en
kelder	V;IND;PRS;1;SG	kelder
kenmerk	V;IND;PRS;1;SG	ken|merk
kerkelijk	ADJ;INDF;NEUT;SG	kerk|elijk
kermen	V;SBJV;PRS;PL	kerm|en
ketters	ADJ;INDF;NEUT;SG	ketter|s
keurig	ADJ;INDF;NEUT;SG	keur|ig
keuvelen	V;SBJV;PRS;PL	keuvel|en
keuvel	V;IND;PRS;1;SG	keuvel
kibbelen	V;SBJV;PRS;PL	kibbel|en
kicken	V;SBJV;PRS;PL	kick|en
kick	V;IND;PRS;1;SG	kick
kiemen	V;SBJV;PRS;PL	kiem|en
kiem	V;IND;PRS;1;SG	kiem
kietelen	V;SBJV;PRS;PL	kietel|en
kijken	V;SBJV;PRS;PL	kijk|en
kijk	V;IND;PRS;1;SG	kijk
kinderachtig	ADJ;INDF;NEUT;SG	kind|erachtig
kinderlijk	ADJ;INDF;NEUT;SG	kind|erlijk
kinderloos	ADJ;INDF;NEUT;SG	kind|erloos
kinds	ADJ;INDF;NEUT;SG	kind|s
kindvriendelijk	ADJ;INDF;NEUT;SG	kind|vriend|elijk
kirren	V;SBJV;PRS;PL	kirr|en
kisten	V;SBJV;PRS;PL	kist|en
kist	V;IND;PRS;3;SG	kist
klaarblijkelijk	ADJ;INDF;NEUT;SG	klaar|blijk|elijk
klaar	ADJ;INDF;NEUT;SG	klaar
klare	ADJ;INDF;PL	klar|e
kladden	V;SBJV;PST;PL	kladd|en
klad	V;IND;PRS;1;SG	klad
klagen	V;SBJV;PRS;PL	klag|en
klam	ADJ;INDF;NEUT;SG	klam
klassieker	ADJ;INDF;PL;CMPR	klassiek|er
klateren	V;SBJV;PRS;PL	klater|en
klauteren	V;SBJV;PRS;PL	klauter|en
klauter	V;IND;PRS;1;SG	klauter
klaverjassen	V;SBJV;PRS;PL	klaver|jass|en
kleineren	V;SBJV;PRS;PL	klein|er|en
kleingeestig	ADJ;INDF;NEUT;SG	klein|geest|ig
kleinzerig	ADJ;INDF;NEUT;SG	klein|zer|ig
kleppen	V;SBJV;PRS;PL	klepp|en
klep	V;IND;PRS;1;SG	klep
kletsen	V;SBJV;PRS;PL	klets|en
klets	V;IND;PRS;1;SG	klets
kletsnat	ADJ;INDF;NEUT;SG	klets|nat
kleuren	V;SBJV;PRS;PL	kleur|en
kleur	V;IND;PRS;1;SG	kleur
kleurloos	ADJ;INDF;NEUT;SG	kleur|loos
kleurrijk	ADJ;INDF;NEUT;SG	kleur|rijk
kleverig	ADJ;INDF;NEUT;SG	klev|erig
klieren	V;SBJV;PRS;PL	klier|en
klier	V;IND;PRS;1;SG	klier
klikken	V;SBJV;PRS;PL	klikk|en
klik	V;IND;PRS;1;SG	klik
klinken	V;SBJV;PRS;PL	klink|en
klink	V;IND;PRS;1;SG	klink
klooien	V;SBJV;PRS;PL	klooi|en
klooi	V;IND;PRS;1;SG	klooi
klotsen	V;SBJV;PRS;PL	klots|en
klots	V;IND;PRS;1;SG	klots
kluisteren	V;SBJV;PRS;PL	kluister|en
kluister	V;IND;PRS;1;SG	kluister
kluppelen	V;SBJV;PRS;PL	kluppel|en
kluppel	V;IND;PRS;1;SG	kluppel
klussen	V;SBJV;PRS;PL	kluss|en
klus	V;IND;PRS;1;SG	klus
klutsen	V;SBJV;PRS;PL	kluts|en
kluts	V;IND;PRS;1;SG	kluts
knabbelen	V;SBJV;PRS;PL	knabbel|en
knabbel	V;IND;PRS;1;SG	knabbel
knagen	V;SBJV;PRS;PL	knag|en
knallen	V;SBJV;PRS;PL	knall|en
knal	V;IND;PRS;1;SG	knal
knap	V;IND;PRS;1;SG	knap
knapper	ADJ;INDF;PL;CMPR	knapp|er
knappen	V;SBJV;PRS;PL	knapp|en
knarsen	V;SBJV;PRS;PL	knars|en
knechten	V;SBJV;PRS;PL	knecht|en
knecht	V;IND;PRS;3;SG	knecht
kneden	V;SBJV;PRS;PL	kned|en
knellen	V;SBJV;PRS;PL	knell|en
knel	V;IND;PRS;1;SG	knel
knetteren	V;SBJV;PRS;PL	knetter|en
knetter	V;IND;PRS;1;SG	knetter
knettergek	ADJ;INDF;NEUT;SG	knetter|gek
kneus	V;IND;PRS;1;SG	kneus
kneuzen	V;SBJV;PRS;PL	kneuzen
knevelen	V;SBJV;PRS;PL	knevel|en
knevel	V;IND;PRS;1;SG	knevel
knielen	V;SBJV;PRS;PL	kniel|en
kneep	V;IND;PST;3;SG	kneep
knijpen	V;SBJV;PRS;PL	knijp|en
knijp	V;IND;PRS;1;SG	knijp
knikken	V;SBJV;PRS;PL	knikk|en
knik	V;IND;PRS;1;SG	knik
knipogen	V;SBJV;PRS;PL	knip|og|en
knipoog	V;IND;PRS;1;SG	knip|oog
knippen	V;SBJV;PRS;PL	knipp|en
knip	V;IND;PRS;1;SG	knip
knipperen	V;SBJV;PRS;PL	knipper|en
knipper	V;IND;PRS;1;SG	knipp|er
knoeien	V;SBJV;PRS;PL	knoei|en
knoei	V;IND;PRS;1;SG	knoei
knorren	V;SBJV;PRS;PL	knorr|en
knor	V;IND;PRS;1;SG	knor
knuffelen	V;SBJV;PRS;PL	knuffel|en
knuffel	V;IND;PRS;1;SG	knuffel
knuppelen	V;SBJV;PRS;PL	knuppel|en
knuppel	V;IND;PRS;1;SG	knuppel
knus	ADJ;INDF;NEUT;SG	knus
knutselen	V;SBJV;PRS;PL	knutsel|en
koelen	V;SBJV;PRS;PL	koel|en
koel	V;IND;PRS;1;SG	koel
koeren	V;SBJV;PRS;PL	koer|en
koer	V;IND;PRS;1;SG	koer
kolken	V;SBJV;PRS;PL	kolk|en
kolk	V;IND;PRS;1;SG	kolk
koloniaal	ADJ;INDF;NEUT;SG	koloni|aal
koloniseren	V;SBJV;PRS;PL	kolon|iser|en
komiek	ADJ;INDF;NEUT;SG	kom|iek
kom	V;IND;PRS;1;SG	kom
kond	ADJ;INDF;NEUT;SG	kond
koninklijk	ADJ;INDF;NEUT;SG	konink|lijk
kontneuken	V;SBJV;PRS;PL	kont|neuk|en
koortsachtig	ADJ;INDF;NEUT;SG	koorts|achtig
koortsig	ADJ;INDF;NEUT;SG	koorts|ig
koppelen	V;SBJV;PRS;PL	koppel|en
koppel	V;IND;PRS;1;SG	koppel
koppen	V;SBJV;PRS;PL	kopp|en
kop	V;IND;PRS;1;SG	kop
koppig	ADJ;INDF;NEUT;SG	kopp|ig
koralen	ADJ;INDF;PL	koral|en
kortademig	ADJ;INDF;NEUT;SG	kort|adem|ig
kortaf	ADJ;INDF;NEUT;SG	kort|af
korten	V;SBJV;PRS;PL	kort|en
kort	V;IND;PRS;3;SG	kort
kortgerokt	ADJ;INDF;NEUT;SG	kort|gerokt
kortstondig	ADJ;INDF;NEUT;SG	kort|stond|ig
kosmisch	ADJ;INDF;NEUT;SG	kosm|isch
kosmopolitisch	ADJ;INDF;NEUT;SG	kosmopolit|isch
kosteloos	ADJ;INDF;NEUT;SG	kost|eloos
kosten	V;SBJV;PRS;PL	kost|en
kost	V;IND;PRS;3;SG	kost
kotsen	V;SBJV;PRS;PL	kots|en
kots	V;IND;PRS;1;SG	kots
kraaien	V;SBJV;PRS;PL	kraai|en
kraai	V;IND;PRS;1;SG	kraai
krabben	V;SBJV;PRS;PL	krabb|en
krabbe	V;SBJV;PRS;SG	krabbe
krab	V;IND;PRS;1;SG	krab
krachteloos	ADJ;INDF;NEUT;SG	kracht|eloos
krachtig	ADJ;INDF;NEUT;SG	kracht|ig
krank	ADJ;INDF;NEUT;SG	krank
krankzinnig	ADJ;INDF;NEUT;SG	krank|zinn|ig
krap	ADJ;INDF;NEUT;SG	krap
kras	V;IND;PRS;1;SG	kras
krasser	ADJ;INDF;PL;CMPR	krass|er
krassen	V;SBJV;PRS;PL	krass|en
kreeftachtig	ADJ;INDF;NEUT;SG	kreeft|achtig
kreuken	V;SBJV;PRS;PL	kreuk|en
kreuk	V;IND;PRS;1;SG	kreuk
kreunen	V;SBJV;PRS;PL	kreunen
kreupel	ADJ;INDF;NEUT;SG	kreupel
kriebelen	V;SBJV;PRS;PL	kriebel|en
kriebel	V;IND;PRS;1;SG	kriebel
krijgen	V;SBJV;PRS;PL	krijg|en
krijg	V;IND;PRS;1;SG	krijg
krijgshaftig	ADJ;INDF;NEUT;SG	krijg|s|haftig
krijsen	V;SBJV;PRS;PL	krijs|en
krijs	V;IND;PRS;1;SG	krijs
krimpen	V;SBJV;PRS;PL	krimp|en
krimp	V;IND;PRS;1;SG	krimp
krioelen	V;SBJV;PRS;PL	krioel|en
kristallen	ADJ;INDF;PL	kristall|en
kritiek	ADJ;INDF;NEUT;SG	krit|iek
kroelen	V;SBJV;PRS;PL	kroel|en
krom	V;IND;PRS;1;SG	krom
krommen	V;SBJV;PRS;PL	kromm|en
kronkelen	V;SBJV;PRS;PL	kronkel|en
kronkel	V;IND;PRS;1;SG	kronkel
kruidachtig	ADJ;INDF;NEUT;SG	kruid|achtig
kruidig	ADJ;INDF;NEUT;SG	kruid|ig
kruiden	V;SBJV;PST;PL	kruid|en
kruien	V;SBJV;PRS;PL	krui|en
kruit	V;IND;PRS;3;SG	kruit
kruipen	V;SBJV;PRS;PL	kruip|en
kruisvormig	ADJ;INDF;NEUT;SG	kruis|vorm|ig
krukken	V;SBJV;PRS;PL	krukk|en
kruk	V;IND;PRS;1;SG	kruk
kubiek	ADJ;INDF;NEUT;SG	kub|iek
kuchen	V;SBJV;PRS;PL	kuch|en
kuch	V;IND;PRS;1;SG	kuch
kuipen	V;SBJV;PRS;PL	kuip|en
kuip	V;IND;PRS;1;SG	kuip
kundig	ADJ;INDF;NEUT;SG	kund|ig
kunstig	ADJ;INDF;NEUT;SG	kunst|ig
kunstmatig	ADJ;INDF;NEUT;SG	kunst|matig
kunstschaats	V;IND;PRS;1;SG	kunst|schaats
kunstzinnig	ADJ;INDF;NEUT;SG	kunst|zinn|ig
kurken	ADJ;INDF;PL	kurk|en
kut	ADJ;INDF;NEUT;SG	kut
kwaadaardig	ADJ;INDF;NEUT;SG	kwaad|aard|ig
kwaad	ADJ;INDF;NEUT;SG	kwaad
kwadraat	ADJ;INDF;NEUT;SG	kwadr|aat
kwaken	V;SBJV;PRS;PL	kwak|en
kwetsbaar	ADJ;INDF;NEUT;SG	kwets|baar
kwetsen	V;SBJV;PRS;PL	kwets|en
kwets	V;IND;PRS;1;SG	kwets
kwiek	ADJ;INDF;NEUT;SG	kwiek
kwijlen	V;SBJV;PRS;PL	kwijl|en
kwijl	V;IND;PRS;1;SG	kwijl
kwijnen	V;SBJV;PRS;PL	kwijnen
kwijten	V;SBJV;PRS;PL	kwijt|en
kwijt	ADJ;INDF;NEUT;SG	kwijt
kwispelen	V;SBJV;PRS;PL	kwispel|en
kwispel	V;IND;PRS;1;SG	kwispel
laagdrempelig	ADJ;INDF;NEUT;SG	laag|drempel|ig
laaien	V;SBJV;PRS;PL	laai|en
laai	V;IND;PRS;1;SG	laai
laars	V;IND;PRS;1;SG	laars
laatstgenoemd	ADJ;INDF;NEUT;SG	laatst|genoemd
lachen	V;SBJV;PRS;PL	lach|en
lach	V;IND;PRS;1;SG	lach
lafhartig	ADJ;INDF;NEUT;SG	laf|hart|ig
laf	ADJ;INDF;NEUT;SG	laf
landelijk	ADJ;INDF;NEUT;SG	land|elijk
landen	V;SBJV;PRS;PL	land|en
land	V;IND;PRS;1;SG	land
langbenig	ADJ;INDF;NEUT;SG	lang|ben|ig
langdradig	ADJ;INDF;NEUT;SG	lang|drad|ig
langdurig	ADJ;INDF;NEUT;SG	lang|dur|ig
langgerekt	ADJ;INDF;NEUT;SG	lang|gerekt
lang	ADJ;INDF;NEUT;SG	lang
lappen	V;SBJV;PRS;PL	lapp|en
lap	V;IND;PRS;1;SG	lap
lassen	V;SBJV;PRS;PL	lass|en
lasten	V;SBJV;PST;PL	last|en
last	V;IND;PRS;3;SG	last
las	V;IND;PST;3;SG	las
lastig	ADJ;INDF;NEUT;SG	last|ig
lauw	ADJ;INDF;NEUT;SG	lauw
lauwer	ADJ;INDF;PL;CMPR	lauwer
laaf	V;IND;PRS;1;SG	laaf
laven	V;SBJV;PRS;PL	laven
lawaaierig	ADJ;INDF;NEUT;SG	lawaai|erig
lederen	ADJ;INDF;PL	leder|en
leder	ADJ;INDF;PL;CMPR	leder
leed	V;IND;PST;3;SG	leed
leefbaar	ADJ;INDF;NEUT;SG	leef|baar
leep	ADJ;INDF;NEUT;SG	leep
leerlooien	V;SBJV;PRS;PL	leer|looi|en
leerzaam	ADJ;INDF;NEUT;SG	leer|zaam
leesbaar	ADJ;INDF;NEUT;SG	lees|baar
legaliseren	V;SBJV;PRS;PL	legal|iser|en
leeg	V;IND;PRS;1;SG	leeg
legen	V;SBJV;PRS;PL	leg|en
legitimeren	V;SBJV;PRS;PL	legitim|er|en
leiden	V;SBJV;PRS;PL	leid|en
lekken	V;SBJV;PRS;PL	lekk|en
lek	ADJ;INDF;NEUT;SG	lek
lekker	ADJ;INDF;PL;CMPR	lekker
lelijk	ADJ;INDF;NEUT;SG	lelijk
leen	V;IND;PRS;1;SG	leen
lenen	V;SBJV;PRS;PL	lenen
lengen	V;SBJV;PRS;PL	leng|en
leng	V;IND;PRS;1;SG	leng
letten	V;SBJV;PST;PL	lett|en
let	V;IND;PRS;3;SG	let
letterlijk	ADJ;INDF;NEUT;SG	letter|lijk
leuk	ADJ;INDF;NEUT;SG	leuk
leunen	V;SBJV;PRS;PL	leunen
levendig	ADJ;INDF;NEUT;SG	levend|ig
levenloos	ADJ;INDF;NEUT;SG	leven|loos
levensecht	ADJ;INDF;NEUT;SG	leven|s|echt
levensgevaarlijk	ADJ;INDF;NEUT;SG	leven|s|gevaar|lijk
levenskrachtig	ADJ;INDF;NEUT;SG	leven|s|kracht|ig
levenslang	ADJ;INDF;NEUT;SG	leven|s|lang
levensmoe	ADJ;INDF;NEUT;SG	leven|s|moe
leveren	V;SBJV;PRS;PL	lever|en
lever	V;IND;PRS;1;SG	lever
leest	V;IND;PRS;3;SG	leest
lezen	V;SBJV;PRS;PL	lezen
lichamelijk	ADJ;INDF;NEUT;SG	licham|elijk
lichtblauw	ADJ;INDF;NEUT;SG	licht|blauw
lichtbruin	ADJ;INDF;NEUT;SG	licht|bruin
lichten	V;SBJV;PRS;PL	licht|en
licht	V;IND;PRS;3;SG	licht
lichtgeel	ADJ;INDF;NEUT;SG	licht|geel
lichtgewicht	ADJ;INDF;PL	licht|gewicht
lichtgrijs	ADJ;INDF;NEUT;SG	licht|grijs
lichtgroen	ADJ;INDF;NEUT;SG	licht|groen
lichtrood	ADJ;INDF;NEUT;SG	licht|rood
lichtvoetig	ADJ;INDF;NEUT;SG	licht|voet|ig
lichtzinnig	ADJ;INDF;NEUT;SG	licht|zinn|ig
liefdadig	ADJ;INDF;NEUT;SG	lief|dad|ig
liefdevol	ADJ;INDF;NEUT;SG	liefde|vol
lieflijk	ADJ;INDF;NEUT;SG	lief|lijk
liegen	V;SBJV;PRS;PL	lieg|en
logen	V;SBJV;PST;PL	log|en
loog	V;IND;PST;3;SG	loog
liften	V;SBJV;PRS;PL	lift|en
lift	V;IND;PRS;3;SG	lift
lijden	V;SBJV;PRS;PL	lijd|en
lijmerig	ADJ;INDF;NEUT;SG	lijm|erig
lijnen	V;SBJV;PRS;PL	lijnen
lijn	V;IND;PRS;1;SG	lijn
lijp	ADJ;INDF;NEUT;SG	lijp
likken	V;SBJV;PRS;PL	likk|en
lik	V;IND;PRS;1;SG	lik
linker	ADJ;INDF;PL	linker
linkshandig	ADJ;INDF;NEUT;SG	links|hand|ig
linnen	ADJ;INDF;PL	linnen
listig	ADJ;INDF;NEUT;SG	list|ig
loden	ADJ;INDF;PL	lod|en
loefwaarts	ADJ;INDF;NEUT;SG	loef|waarts
loeien	V;SBJV;PRS;PL	loei|en
loei	V;IND;PRS;1;SG	loei
loepzuiver	ADJ;INDF;NEUT;SG	loep|zuiver
loeren	V;SBJV;PRS;PL	loer|en
loer	V;IND;PRS;1;SG	loer
lofwaardig	ADJ;INDF;NEUT;SG	lof|waard|ig
lollig	ADJ;INDF;NEUT;SG	loll|ig
lomp	ADJ;INDF;NEUT;SG	lomp
lonken	V;SBJV;PRS;PL	lonk|en
lonk	V;IND;PRS;1;SG	lonk
loodrecht	ADJ;INDF;NEUT;SG	lood|recht
loodvrij	ADJ;INDF;NEUT;SG	lood|vrij
looien	V;SBJV;PRS;PL	looi|en
looi	V;IND;PRS;1;SG	looi
loom	ADJ;INDF;NEUT;SG	loom
loos	V;IND;PRS;1;SG	loos
losbandig	ADJ;INDF;NEUT;SG	los|band|ig
loslippig	ADJ;INDF;NEUT;SG	los|lipp|ig
lossen	V;SBJV;PRS;PL	loss|en
los	V;IND;PRS;1;SG	los
louteren	V;SBJV;PRS;PL	louter|en
louter	ADJ;INDF;NEUT;SG	louter
lozen	V;SBJV;PRS;PL	lozen
luchten	V;SBJV;PRS;PL	lucht|en
lucht	V;IND;PRS;3;SG	lucht
luchtig	ADJ;INDF;NEUT;SG	lucht|ig
luchtziek	ADJ;INDF;NEUT;SG	lucht|ziek
geluid	V.PTCP;PST	ge|luid
luiden	V;SBJV;PRS;PL	luid|en
luid	V;IND;PRS;1;SG	luid
luidkeels	ADJ;INDF;NEUT;SG	luid|keel|s
look	V;IND;PST;3;SG	look
luiken	V;SBJV;PRS;PL	luik|en
luik	V;IND;PRS;1;SG	luik
lukken	V;SBJV;PRS;PL	lukk|en
luk	V;IND;PRS;1;SG	luk
lummelen	V;SBJV;PRS;PL	lummel|en
lummel	V;IND;PRS;1;SG	lummel
lusteloos	ADJ;INDF;NEUT;SG	lust|eloos
lusten	V;SBJV;PRS;PL	lust|en
lust	V;IND;PRS;3;SG	lust
luw	ADJ;INDF;NEUT;SG	luw
maagdelijk	ADJ;INDF;NEUT;SG	maagd|elijk
maatschappelijk	ADJ;INDF;NEUT;SG	maat|schapp|elijk
machinaal	ADJ;INDF;NEUT;SG	machin|aal
machteloos	ADJ;INDF;NEUT;SG	macht|eloos
machtig	ADJ;INDF;NEUT;SG	macht|ig
maffen	V;SBJV;PRS;PL	maff|en
maf	ADJ;INDF;NEUT;SG	maf
maffer	ADJ;INDF;PL;CMPR	maff|er
mager	ADJ;INDF;NEUT;SG	mager
magnetisch	ADJ;INDF;NEUT;SG	magnet|isch
mailen	V;SBJV;PRS;PL	mail|en
mail	V;IND;PRS;1;SG	mail
maak	V;IND;PRS;1;SG	maak
maken	V;SBJV;PRS;PL	mak|en
makkelijk	ADJ;INDF;NEUT;SG	makk|e|lijk
makken	V;SBJV;PRS;PL	makk|en
makke	V;SBJV;PRS;SG	makk|e
mak	V;IND;PRS;1;SG	mak
mallen	V;SBJV;PRS;PL	mall|en
mal	ADJ;INDF;NEUT;SG	mal
mals	ADJ;INDF;NEUT;SG	mals
manifesteren	V;SBJV;PRS;PL	manifest|er|en
mankeren	V;SBJV;PRS;PL	mank|er|en
mank	ADJ;INDF;NEUT;SG	mank
mannelijk	ADJ;INDF;NEUT;SG	mann|elijk
marineblauw	ADJ;INDF;NEUT;SG	marine|blauw
markeren	V;SBJV;PRS;PL	mark|er|en
martelen	V;SBJV;PRS;PL	martel|en
maskeren	V;SBJV;PRS;PL	masker|en
masker	V;IND;PRS;1;SG	masker
massaal	ADJ;INDF;NEUT;SG	mass|aal
mateloos	ADJ;INDF;NEUT;SG	mat|eloos
materieel	ADJ;INDF;NEUT;SG	mater|ieel
matig	V;IND;PRS;1;SG	mat|ig
maximaal	ADJ;INDF;NEUT;SG	maxim|aal
maximaliseren	V;SBJV;PRS;PL	maxim|al|iser|en
medeplichtig	ADJ;INDF;NEUT;SG	mede|plicht|ig
meelijwekkend	ADJ;INDF;NEUT;SG	mee|lij|wekk|end
meerlettergrepig	ADJ;INDF;NEUT;SG	meer|lettergrep|ig
meertalig	ADJ;INDF;NEUT;SG	meer|tal|ig
meetbaar	ADJ;INDF;NEUT;SG	meet|baar
meinedig	ADJ;INDF;NEUT;SG	meined|ig
melden	V;SBJV;PRS;PL	meld|en
melig	ADJ;INDF;NEUT;SG	mel|ig
melken	V;SBJV;PRS;PL	melk|en
melk	V;IND;PRS;1;SG	melk
melodieus	ADJ;INDF;NEUT;SG	melod|i|eus
memorabel	ADJ;INDF;NEUT;SG	memor|abel
meent	V;IND;PRS;3;SG	meent
menen	V;SBJV;PRS;PL	menen
mengen	V;SBJV;PRS;PL	meng|en
menselijk	ADJ;INDF;NEUT;SG	mens|elijk
meppen	V;SBJV;PRS;PL	mepp|en
mep	V;IND;PRS;1;SG	mep
merken	V;SBJV;PRS;PL	merk|en
merk	V;IND;PRS;1;SG	merk
merkwaardig	ADJ;INDF;NEUT;SG	merk|waard|ig
metaforisch	ADJ;INDF;NEUT;SG	metafor|isch
metafysisch	ADJ;INDF;NEUT;SG	meta|fysisch
metriek	ADJ;INDF;NEUT;SG	metr|iek
metrisch	ADJ;INDF;NEUT;SG	metr|isch
metselen	V;SBJV;PRS;PL	metsel|en
meuken	V;SBJV;PRS;PL	meuk|en
meuk	V;IND;PRS;1;SG	meuk
meuren	V;SBJV;PRS;PL	meur|en
miauwen	V;SBJV;PRS;PL	miauw|en
microscopisch	ADJ;INDF;NEUT;SG	microscop|isch
middeleeuws	ADJ;INDF;NEUT;SG	middel|eeuw|s
middelmatig	ADJ;INDF;NEUT;SG	middel|mat|ig
miezeren	V;SBJV;PRS;PL	miezer|en
miezerig	ADJ;INDF;NEUT;SG	miezer|ig
mede	V;SBJV;PST;SG	mede
mijden	V;SBJV;PRS;PL	mijd|en
mijmeren	V;SBJV;PRS;PL	mijmer|en
mikken	V;SBJV;PRS;PL	mikk|en
mik	V;IND;PRS;1;SG	mik
mild	ADJ;INDF;NEUT;SG	mild
milieuvriendelijk	ADJ;INDF;NEUT;SG	milieu|vriend|elijk
minachten	V;SBJV;PRS;PL	min|acht|en
minderjarig	ADJ;INDF;NEUT;SG	minder|jar|ig
minimaliseren	V;SBJV;PRS;PL	minim|al|iser|en
minimalistisch	ADJ;INDF;NEUT;SG	minim|al|ist|isch
minzaam	ADJ;INDF;NEUT;SG	min|zaam
miraculeus	ADJ;INDF;NEUT;SG	miracul|eus
misdadig	ADJ;INDF;NEUT;SG	mis|dad|ig
mishandelen	V;SBJV;PRS;PL	mis|handel|en
miskennen	V;SBJV;PRS;PL	mis|kennen
misleiden	V;SBJV;PRS;PL	mis|leid|en
mislukken	V;SBJV;PRS;PL	mis|lukk|en
misprijzen	V;SBJV;PRS;PL	mis|prijzen
missen	V;SBJV;PRS;PL	miss|en
misten	V;SBJV;PST;PL	mist|en
mist	V;IND;PRS;3;SG	mist
mis	V;IND;PRS;1;SG	mis
mistig	ADJ;INDF;NEUT;SG	mist|ig
mistroostig	ADJ;INDF;NEUT;SG	mis|troost|ig
mobiel	ADJ;INDF;NEUT;SG	mobiel
mobiliseren	V;SBJV;PRS;PL	mobil|iser|en
modaal	ADJ;INDF;NEUT;SG	mod|aal
moderniseren	V;SBJV;PRS;PL	modern|iser|en
moedeloos	ADJ;INDF;NEUT;SG	moed|eloos
moederlijk	ADJ;INDF;NEUT;SG	moeder|lijk
moedig	ADJ;INDF;NEUT;SG	moed|ig
moeilijk	ADJ;INDF;NEUT;SG	moei|lijk
moeiteloos	ADJ;INDF;NEUT;SG	moeite|loos
moe	ADJ;INDF;NEUT;SG	moe
moerassig	ADJ;INDF;NEUT;SG	moerass|ig
moeten	V;SBJV;PRS;PL	moet|en
moet	V;IND;PRS;3;SG	moet
mogen	V;SBJV;PRS;PL	mog|en
mokken	V;SBJV;PRS;PL	mokk|en
mok	V;IND;PRS;1;SG	mok
mompelen	V;SBJV;PRS;PL	mompel|en
mondig	ADJ;INDF;NEUT;SG	mond|ig
monsteren	V;SBJV;PRS;PL	monster|en
monster	V;IND;PRS;1;SG	monster
monteren	V;SBJV;PRS;PL	monter|en
monumentaal	ADJ;INDF;NEUT;SG	monument|aal
mooi	ADJ;INDF;NEUT;SG	mooi
moorden	V;SBJV;PRS;PL	moord|en
moord	V;IND;PRS;1;SG	moord
mop	V;IND;PRS;1;SG	mop
mopperen	V;SBJV;PRS;PL	mopper|en
morrelen	V;SBJV;PRS;PL	morrel|en
morren	V;SBJV;PRS;PL	morr|en
morsen	V;SBJV;PRS;PL	mors|en
morse	V;SBJV;PRS;SG	morse
motiveren	V;SBJV;PRS;PL	motiv|er|en
motorboot	V;IND;PRS;3;SG	motor|boot
motregenen	V;SBJV;PRS;PL	mot|regenen
motregen	V;IND;PRS;1;SG	mot|regen
muf	ADJ;INDF;NEUT;SG	muf
muil	V;IND;PRS;1;SG	muil
muilkorf	V;IND;PRS;1;SG	muil|korf
muilkorven	V;SBJV;PRS;PL	muil|korven
muilpeer	V;IND;PRS;1;SG	muil|peer
muisstil	ADJ;INDF;NEUT;SG	muis|stil
muiten	V;SBJV;PRS;PL	muit|en
muit	V;IND;PRS;3;SG	muit
multilateraal	ADJ;INDF;NEUT;SG	multi|lateraal
murw	ADJ;INDF;NEUT;SG	murw
muurvast	ADJ;INDF;NEUT;SG	muur|vast
muzikaal	ADJ;INDF;NEUT;SG	muzik|aal
naadloos	ADJ;INDF;NEUT;SG	naad|loos
naamloos	ADJ;INDF;NEUT;SG	naam|loos
naamwoordelijk	ADJ;INDF;NEUT;SG	naam|woord|elijk
naasten	V;SBJV;PRS;PL	naast|en
nabijgelegen	ADJ;INDF;PL	nabij|gelegen
naburig	ADJ;INDF;NEUT;SG	na|bur|ig
nachtblind	ADJ;INDF;NEUT;SG	nacht|blind
nachtelijk	ADJ;INDF;NEUT;SG	nacht|elijk
nachtmerrieachtig	ADJ;INDF;NEUT;SG	nachtmerrie|achtig
nadelig	ADJ;INDF;NEUT;SG	nadel|ig
nadrukkelijk	ADJ;INDF;NEUT;SG	na|drukk|elijk
naakt	V;IND;PRS;3;SG	naakt
naken	V;SBJV;PRS;PL	nak|en
nalatig	ADJ;INDF;NEUT;SG	na|lat|ig
naoorlogs	ADJ;INDF;NEUT;SG	na|oorlog|s
narrig	ADJ;INDF;NEUT;SG	narr|ig
nationaal	ADJ;INDF;NEUT;SG	nat|ionaal
nat	ADJ;INDF;NEUT;SG	nat
natuurkundig	ADJ;INDF;NEUT;SG	natuur|kund|ig
natuurlijk	ADJ;INDF;NEUT;SG	natuur|lijk
neerwaarts	ADJ;INDF;NEUT;SG	neer|waarts
negatief	ADJ;INDF;NEUT;SG	neg|at|ief
negenvoudig	ADJ;INDF;NEUT;SG	negenvoud|ig
negeren	V;SBJV;PRS;PL	neger|en
neigen	V;SBJV;PRS;PL	neig|en
nekken	V;SBJV;PRS;PL	nekk|en
nek	V;IND;PRS;1;SG	nek
namen	V;SBJV;PST;PL	nam|en
nemen	V;SBJV;PRS;PL	nem|en
nep	ADJ;INDF;NEUT;SG	nep
nepper	ADJ;INDF;PL;CMPR	nepp|er
neuken	V;SBJV;PRS;PL	neuk|en
neurotisch	ADJ;INDF;NEUT;SG	neurot|isch
neuspeuteren	V;SBJV;PRS;PL	neus|peuter|en
nevelig	ADJ;INDF;NEUT;SG	nevel|ig
nieten	V;SBJV;PRS;PL	niet|en
niet	V;IND;PRS;3;SG	niet
nietszeggend	ADJ;INDF;NEUT;SG	niets|zegg|end
nieuwsgierig	ADJ;INDF;NEUT;SG	nieuws|gierig
nijdig	ADJ;INDF;NEUT;SG	nijd|ig
negen	V;SBJV;PST;PL	negen
nijgen	V;SBJV;PRS;PL	nijg|en
nikkelen	ADJ;INDF;PL	nikkel|en
nippen	V;SBJV;PRS;PL	nipp|en
nipt	ADJ;INDF;NEUT;SG	nipt
nodeloos	ADJ;INDF;NEUT;SG	nod|eloos
nodiger	ADJ;INDF;PL;CMPR	nodig|er
noemen	V;SBJV;PRS;PL	noem|en
noemenswaardig	ADJ;INDF;NEUT;SG	noem|ens|waard|ig
noest	ADJ;INDF;NEUT;SG	noest
nominaal	ADJ;INDF;NEUT;SG	nomin|aal
nominatief	ADJ;INDF;NEUT;SG	nominat|ief
noodzakelijk	ADJ;INDF;NEUT;SG	nood|zak|elijk
noordoostelijk	ADJ;INDF;NEUT;SG	noord|oost|elijk
noordwestelijk	ADJ;INDF;NEUT;SG	noord|west|elijk
nopen	V;SBJV;PRS;PL	nop|en
normaal	ADJ;INDF;NEUT;SG	norm|aal
nors	ADJ;INDF;NEUT;SG	nors
noteren	V;SBJV;PRS;PL	not|er|en
nuchter	ADJ;INDF;NEUT;SG	nuchter
nutteloos	ADJ;INDF;NEUT;SG	nutt|eloos
nuttig	ADJ;INDF;NEUT;SG	nutt|ig
oefenen	V;SBJV;PRS;PL	oefenen
oehoe	V;IND;PRS;1;SG	oehoe
oeroud	ADJ;INDF;NEUT;SG	oer|oud
oeverloos	ADJ;INDF;NEUT;SG	oever|loos
offeren	V;SBJV;PRS;PL	offer|en
offer	V;IND;PRS;1;SG	offer
officieel	ADJ;INDF;NEUT;SG	offic|ieel
oliehoudend	ADJ;INDF;NEUT;SG	olie|houd|end
olie	V;IND;PRS;1;SG	olie
olijfgroen	ADJ;INDF;NEUT;SG	olijf|groen
olijfkleurig	ADJ;INDF;NEUT;SG	olijf|kleur|ig
omcirkelen	V;SBJV;PRS;PL	om|cirkel|en
omkeerbaar	ADJ;INDF;NEUT;SG	om|keer|baar
omklemmen	V;SBJV;PRS;PL	om|klemm|en
omringen	V;SBJV;PRS;PL	om|ring|en
omsingelen	V;SBJV;PRS;PL	om|singel|en
omsluiten	V;SBJV;PRS;PL	om|sluit|en
omvangrijk	ADJ;INDF;NEUT;SG	omvang|rijk
omvatten	V;SBJV;PST;PL	om|vatt|en
omwikkelen	V;SBJV;PRS;PL	om|wikkel|en
omzeilen	V;SBJV;PRS;PL	om|zeil|en
omzwerven	V;SBJV;PRS;PL	om|zwerven
onaangenaam	ADJ;INDF;NEUT;SG	on|aangenaam
onaangeroerd	ADJ;INDF;NEUT;SG	on|aangeroerd
onaangesproken	ADJ;INDF;PL	on|aangesproken
onaantrekkelijk	ADJ;INDF;NEUT;SG	on|aan|trekk|elijk
onaanvaardbaar	ADJ;INDF;NEUT;SG	on|aanvaard|baar
onachtzaam	ADJ;INDF;NEUT;SG	on|acht|zaam
onafgewerkt	ADJ;INDF;NEUT;SG	on|afgewerkt
onafhankelijk	ADJ;INDF;NEUT;SG	on|af|hank|elijk
onbedoeld	ADJ;INDF;NEUT;SG	on|bedoeld
onbeduidend	ADJ;INDF;NEUT;SG	on|beduidend
onbegaanbaar	ADJ;INDF;NEUT;SG	on|begaan|baar
onbegeleid	ADJ;INDF;NEUT;SG	on|begeleid
onbehaaglijk	ADJ;INDF;NEUT;SG	on|be|haag|lijk
onbeheerst	ADJ;INDF;NEUT;SG	on|beheerst
onbehoorlijk	ADJ;INDF;NEUT;SG	on|be|hoor|lijk
onbekend	ADJ;INDF;NEUT;SG	on|bekend
onbekwaam	ADJ;INDF;NEUT;SG	on|bekwaam
onbelastbaar	ADJ;INDF;NEUT;SG	on|be|last|baar
onbemand	ADJ;INDF;NEUT;SG	on|bemand
onbepaald	ADJ;INDF;NEUT;SG	on|bepaald
onbeperkt	ADJ;INDF;NEUT;SG	on|beperkt
onbereikbaar	ADJ;INDF;NEUT;SG	on|be|reik|baar
onberispelijk	ADJ;INDF;NEUT;SG	on|berisp|elijk
onbeschaafd	ADJ;INDF;NEUT;SG	on|beschaafd
onbeschrijfelijk	ADJ;INDF;NEUT;SG	on|be|schrijf|elijk
onbetaalbaar	ADJ;INDF;NEUT;SG	on|betaal|baar
onbeteugeld	ADJ;INDF;NEUT;SG	on|beteugeld
onbetwist	ADJ;INDF;NEUT;SG	on|betwist
onbevreesd	ADJ;INDF;NEUT;SG	on|be|vrees|d
onbeweeglijk	ADJ;INDF;NEUT;SG	on|beweeg|lijk
onbewogen	ADJ;INDF;PL	on|bewogen
onbewoond	ADJ;INDF;NEUT;SG	on|bewoond
onbezield	ADJ;INDF;NEUT;SG	on|bezield
onbezonnen	ADJ;INDF;PL	on|bezonnen
onbruikbaar	ADJ;INDF;NEUT;SG	on|bruik|baar
ondankbaar	ADJ;INDF;NEUT;SG	on|dankbaar
ondenkbaar	ADJ;INDF;NEUT;SG	on|denk|baar
onderaards	ADJ;INDF;NEUT;SG	onder|aard|s
onderbewust	ADJ;INDF;NEUT;SG	onder|bewust
onderbouwen	V;SBJV;PRS;PL	onder|bouw|en
onderbouw	V;IND;PRS;1;SG	onder|bouw
onderbreken	V;SBJV;PRS;PL	onder|brek|en
onderdanig	ADJ;INDF;NEUT;SG	onderdan|ig
onderdrukken	V;SBJV;PRS;PL	onder|drukk|en
onderdruk	V;IND;PRS;1;SG	onder|druk
ondergeschikt	ADJ;INDF;NEUT;SG	onder|geschikt
ondergronds	ADJ;INDF;NEUT;SG	onder|grond|s
ondergrondse	ADJ;INDF;PL	onder|grond|s|e
onderhandelen	V;SBJV;PRS;PL	onder|handel|en
onderkennen	V;SBJV;PRS;PL	onder|kennen
ondermijnen	V;SBJV;PRS;PL	onder|mijnen
onderstaand	ADJ;INDF;NEUT;SG	onder|staand
ondersteunen	V;SBJV;PRS;PL	onder|steunen
onderstrepen	V;SBJV;PRS;PL	onder|strep|en
ondertekenen	V;SBJV;PRS;PL	onder|tekenen
ondervinden	V;SBJV;PRS;PL	onder|vind|en
onderwerpen	V;SBJV;PRS;PL	onder|werp|en
onderwijskundig	ADJ;INDF;NEUT;SG	onderwijs|kund|ig
onderzoeken	V;SBJV;PRS;PL	onder|zoek|en
ondeugdelijk	ADJ;INDF;NEUT;SG	on|deugd|elijk
ondiep	ADJ;INDF;NEUT;SG	on|diep
ondoordacht	ADJ;INDF;NEUT;SG	on|doordacht
ondoordringbaar	ADJ;INDF;NEUT;SG	on|door|dring|baar
ondoorzichtig	ADJ;INDF;NEUT;SG	on|door|zi|chtig
ondrinkbaar	ADJ;INDF;NEUT;SG	on|drink|baar
onduidelijk	ADJ;INDF;NEUT;SG	on|duid|elijk
oneerbiedig	ADJ;INDF;NEUT;SG	on|eerbied|ig
oneerlijk	ADJ;INDF;NEUT;SG	on|eer|lijk
oneffen	ADJ;INDF;PL	on|effen
oneindig	ADJ;INDF;NEUT;SG	on|eind|ig
onervaren	ADJ;INDF;PL	on|ervaren
onethisch	ADJ;INDF;NEUT;SG	on|ethisch
oneven	ADJ;INDF;PL	on|even
onfatsoenlijk	ADJ;INDF;NEUT;SG	on|fatsoen|lijk
onfeilbaar	ADJ;INDF;NEUT;SG	on|feilbaar
ongebruikelijk	ADJ;INDF;NEUT;SG	on|gebruik|elijk
ongecontroleerd	ADJ;INDF;NEUT;SG	on|gecontroleerd
ongedaan	ADJ;INDF;NEUT;SG	on|gedaan
ongedeeld	ADJ;INDF;NEUT;SG	on|gedeeld
ongedeerd	ADJ;INDF;NEUT;SG	on|gedeerd
ongeduldig	ADJ;INDF;NEUT;SG	on|geduld|ig
ongedwongen	ADJ;INDF;PL	on|gedwongen
ongefundeerd	ADJ;INDF;NEUT;SG	on|gefundeerd
ongehoord	ADJ;INDF;NEUT;SG	on|gehoord
ongehoorzaam	ADJ;INDF;NEUT;SG	on|gehoorzaam
ongehuwd	ADJ;INDF;NEUT;SG	on|gehuwd
ongekend	ADJ;INDF;NEUT;SG	on|gekend
ongeldig	ADJ;INDF;NEUT;SG	on|geldig
ongelegen	ADJ;INDF;PL	on|gelegen
ongeletterd	ADJ;INDF;NEUT;SG	on|geletterd
ongelezen	ADJ;INDF;PL	on|gelezen
ongelijkmatig	ADJ;INDF;NEUT;SG	on|gelijk|mat|ig
ongelofelijk	ADJ;INDF;NEUT;SG	on|gelof|elijk
ongelooflijk	ADJ;INDF;NEUT;SG	on|geloof|lijk
ongelovig	ADJ;INDF;NEUT;SG	on|gelov|ig
ongelukkig	ADJ;INDF;NEUT;SG	on|ge|lukk|ig
ongenaakbaar	ADJ;INDF;NEUT;SG	on|genaak|baar
ongenadig	ADJ;INDF;NEUT;SG	on|genad|ig
ongeneeslijk	ADJ;INDF;NEUT;SG	on|genees|lijk
ongeoorloofd	ADJ;INDF;NEUT;SG	on|geoorloofd
ongeremd	ADJ;INDF;NEUT;SG	on|geremd
ongerept	ADJ;INDF;NEUT;SG	on|gerept
ongerust	ADJ;INDF;NEUT;SG	on|gerust
ongeschikt	ADJ;INDF;NEUT;SG	on|geschikt
ongeschreven	ADJ;INDF;PL	on|geschreven
ongestoord	ADJ;INDF;NEUT;SG	on|gestoord
ongetrouwd	ADJ;INDF;NEUT;SG	on|getrouwd
ongevaarlijk	ADJ;INDF;NEUT;SG	on|gevaar|lijk
ongevoelig	ADJ;INDF;NEUT;SG	on|ge|voel|ig
ongewenst	ADJ;INDF;NEUT;SG	on|gewenst
ongewerveld	ADJ;INDF;NEUT;SG	on|gewerveld
ongewijzigd	ADJ;INDF;NEUT;SG	on|gewijzigd
ongewis	ADJ;INDF;NEUT;SG	on|gewis
ongewoon	ADJ;INDF;NEUT;SG	on|gewoon
ongezien	ADJ;INDF;NEUT;SG	on|gezien
ongunstig	ADJ;INDF;NEUT;SG	on|gun|st|ig
onhandelbaar	ADJ;INDF;NEUT;SG	on|handel|baar
onhandig	ADJ;INDF;NEUT;SG	on|hand|ig
onhebbelijk	ADJ;INDF;NEUT;SG	on|hebb|elijk
onheilig	ADJ;INDF;NEUT;SG	on|heilig
onheilspellend	ADJ;INDF;NEUT;SG	on|heil|spell|end
onherbergzaam	ADJ;INDF;NEUT;SG	on|herberg|zaam
onherstelbaar	ADJ;INDF;NEUT;SG	on|herstel|baar
onhoorbaar	ADJ;INDF;NEUT;SG	on|hoor|baar
onhoudbaar	ADJ;INDF;NEUT;SG	on|houd|baar
onjuist	ADJ;INDF;NEUT;SG	on|juist
onkreukbaar	ADJ;INDF;NEUT;SG	on|kreuk|baar
onkwetsbaar	ADJ;INDF;NEUT;SG	on|kwets|baar
onleesbaar	ADJ;INDF;NEUT;SG	on|lees|baar
onlosmakelijk	ADJ;INDF;NEUT;SG	on|los|mak|elijk
onmannelijk	ADJ;INDF;NEUT;SG	on|mann|elijk
onmiddellijk	ADJ;INDF;NEUT;SG	on|middel|lijk
onmisbaar	ADJ;INDF;NEUT;SG	on|mis|baar
onmiskenbaar	ADJ;INDF;NEUT;SG	on|mis|ken|baar
onmogelijk	ADJ;INDF;NEUT;SG	on|mogelijk
onnodig	ADJ;INDF;NEUT;SG	on|nodig
onnozel	ADJ;INDF;NEUT;SG	onnozel
onomkeerbaar	ADJ;INDF;NEUT;SG	on|om|keer|baar
onomstotelijk	ADJ;INDF;NEUT;SG	on|om|stot|elijk
onomstreden	ADJ;INDF;PL	on|omstreden
ononderbroken	ADJ;INDF;PL	on|onderbroken
onontbeerlijk	ADJ;INDF;NEUT;SG	on|ontbeer|lijk
onophoudelijk	ADJ;INDF;NEUT;SG	on|op|houd|elijk
onoplettend	ADJ;INDF;NEUT;SG	on|oplettend
onopvallend	ADJ;INDF;NEUT;SG	on|opvallend
onoverbrugbaar	ADJ;INDF;NEUT;SG	on|overbrug|baar
onovergankelijk	ADJ;INDF;NEUT;SG	on|overgankelijk
onovertroffen	ADJ;INDF;PL	on|overtroffen
onoverwinnelijk	ADJ;INDF;NEUT;SG	on|over|winn|elijk
onpaar	ADJ;INDF;NEUT;SG	on|paar
onpartijdig	ADJ;INDF;NEUT;SG	on|partijdig
onpersoonlijk	ADJ;INDF;NEUT;SG	on|persoon|lijk
onplezierig	ADJ;INDF;NEUT;SG	on|plezier|ig
onpraktisch	ADJ;INDF;NEUT;SG	on|praktisch
onrecht	ADJ;INDF;NEUT;SG	on|recht
onrechtstreeks	ADJ;INDF;NEUT;SG	on|recht|streek|s
onregelmatig	ADJ;INDF;NEUT;SG	on|regel|matig
onrein	ADJ;INDF;NEUT;SG	on|rein
onrustig	ADJ;INDF;NEUT;SG	on|rust|ig
onsamenhangend	ADJ;INDF;NEUT;SG	on|samenhangend
onschadelijk	ADJ;INDF;NEUT;SG	on|schad|elijk
onscheidbaar	ADJ;INDF;NEUT;SG	on|scheid|baar
onschendbaar	ADJ;INDF;NEUT;SG	on|schend|baar
onscherp	ADJ;INDF;NEUT;SG	on|scherp
onschuldig	ADJ;INDF;NEUT;SG	on|schuld|ig
onsmakelijk	ADJ;INDF;NEUT;SG	on|smak|elijk
onsterfelijk	ADJ;INDF;NEUT;SG	on|sterf|elijk
ontaarden	V;SBJV;PRS;PL	ont|aard|en
ontbinden	V;SBJV;PRS;PL	ont|bind|en
ontbloten	V;SBJV;PRS;PL	ont|blot|en
ontbranden	V;SBJV;PRS;PL	ont|brand|en
ontcijferen	V;SBJV;PRS;PL	ont|cijfer|en
ontdekken	V;SBJV;PRS;PL	ont|dekk|en
ontdooien	V;SBJV;PRS;PL	ont|dooi|en
ontduiken	V;SBJV;PRS;PL	ont|duik|en
onteigenen	V;SBJV;PRS;PL	ont|eigenen
ontelbaar	ADJ;INDF;NEUT;SG	on|tel|baar
onterecht	ADJ;INDF;NEUT;SG	on|te|recht
onteren	V;SBJV;PRS;PL	ont|er|en
onterven	V;SBJV;PRS;PL	ont|erven
ontevreden	ADJ;INDF;PL	on|tevreden
ontfutselen	V;SBJV;PRS;PL	ont|futsel|en
ontgassen	V;SBJV;PRS;PL	ont|gass|en
ontgoochelen	V;SBJV;PRS;PL	ont|goochel|en
ontgroeien	V;SBJV;PRS;PL	ont|groei|en
ontgroenen	V;SBJV;PRS;PL	ont|groenen
onthalen	V;SBJV;PRS;PL	ont|hal|en
ontharen	V;SBJV;PRS;PL	ont|har|en
ontheiligen	V;SBJV;PRS;PL	ont|heilig|en
onthoofden	V;SBJV;PRS;PL	ont|hoofd|en
onthullen	V;SBJV;PRS;PL	ont|hull|en
onthutsen	V;SBJV;PRS;PL	ont|huts|en
ontkennen	V;SBJV;PRS;PL	ont|kennen
ontketenen	V;SBJV;PRS;PL	ont|ketenen
ontkiemen	V;SBJV;PRS;PL	ont|kiem|en
ontkoppelen	V;SBJV;PRS;PL	ont|koppel|en
ontkrachten	V;SBJV;PRS;PL	ont|kracht|en
ontkurken	V;SBJV;PRS;PL	ont|kurk|en
ontlasten	V;SBJV;PRS;PL	ont|last|en
ontlenen	V;SBJV;PRS;PL	ont|lenen
ontlokken	V;SBJV;PRS;PL	ont|lokk|en
ontluiken	V;SBJV;PRS;PL	ont|luik|en
ontmaagden	V;SBJV;PRS;PL	ont|maagd|en
ontmaskeren	V;SBJV;PRS;PL	ont|masker|en
ontmoedigen	V;SBJV;PRS;PL	ont|moed|ig|en
ontnemen	V;SBJV;PRS;PL	ont|nem|en
ontnuchteren	V;SBJV;PRS;PL	ont|nuchter|en
ontoereikend	ADJ;INDF;NEUT;SG	on|toereikend
ontploffen	V;SBJV;PRS;PL	ont|ploff|en
ontplooien	V;SBJV;PRS;PL	ont|plooi|en
ontrafelen	V;SBJV;PRS;PL	ont|rafel|en
ontregelen	V;SBJV;PRS;PL	ont|regel|en
ontroeren	V;SBJV;PRS;PL	ont|roer|en
ontrollen	V;SBJV;PRS;PL	ont|roll|en
ontroostbaar	ADJ;INDF;NEUT;SG	on|troost|baar
ontrouw	ADJ;INDF;NEUT;SG	on|trouw
ontruimen	V;SBJV;PRS;PL	ont|ruim|en
ontsieren	V;SBJV;PRS;PL	ont|sier|en
ontsluieren	V;SBJV;PRS;PL	ont|sluier|en
ontsluiten	V;SBJV;PRS;PL	ont|sluit|en
ontsnappen	V;SBJV;PRS;PL	ont|snapp|en
ontsporen	V;SBJV;PRS;PL	ont|spor|en
ontspringen	V;SBJV;PRS;PL	ont|spring|en
ontspruiten	V;SBJV;PRS;PL	ont|spruit|en
ontstellen	V;SBJV;PRS;PL	ont|stell|en
ontstemmen	V;SBJV;PRS;PL	ont|stemm|en
onttrekken	V;SBJV;PRS;PL	ont|trekk|en
ontvluchten	V;SBJV;PRS;PL	ont|vlucht|en
ontvolken	V;SBJV;PRS;PL	ont|volk|en
ontwaken	V;SBJV;PRS;PL	ont|wak|en
ontwarren	V;SBJV;PRS;PL	ont|warr|en
ontwateren	V;SBJV;PRS;PL	ont|water|en
ontwennen	V;SBJV;PRS;PL	ont|wennen
ontwijken	V;SBJV;PRS;PL	ont|wijk|en
ontwikkelen	V;SBJV;PRS;PL	ont|wikkel|en
ontworstelen	V;SBJV;PRS;PL	ont|worstel|en
ontzaglijk	ADJ;INDF;NEUT;SG	ontzag|lijk
ontzeggen	V;SBJV;PRS;PL	ont|zegg|en
ontzilten	V;SBJV;PRS;PL	ont|zilt|en
onuitstaanbaar	ADJ;INDF;NEUT;SG	on|uit|staa|nbaar
onuitwisbaar	ADJ;INDF;NEUT;SG	on|uit|wis|baar
onveilig	ADJ;INDF;NEUT;SG	on|veilig
onveranderlijk	ADJ;INDF;NEUT;SG	on|verander|lijk
onverbeterlijk	ADJ;INDF;NEUT;SG	on|ver|beter|lijk
onverdienstelijk	ADJ;INDF;NEUT;SG	on|verdien|ste|lijk
onverdraaglijk	ADJ;INDF;NEUT;SG	on|ver|draag|lijk
onverdraagzaam	ADJ;INDF;NEUT;SG	on|ver|draag|zaam
onverenigbaar	ADJ;INDF;NEUT;SG	on|verenig|baar
onvergeeflijk	ADJ;INDF;NEUT;SG	on|ver|geef|lijk
onvergelijkbaar	ADJ;INDF;NEUT;SG	on|ver|gelijk|baar
onverholen	ADJ;INDF;PL	on|verholen
onverhoopt	ADJ;INDF;NEUT;SG	on|verhoopt
onvermijdelijk	ADJ;INDF;NEUT;SG	on|ver|mijd|elijk
onvermoeibaar	ADJ;INDF;NEUT;SG	on|ver|moe|ibaar
onvermoeid	ADJ;INDF;NEUT;SG	on|vermoeid
onverschrokken	ADJ;INDF;PL	on|verschrokken
onverstandig	ADJ;INDF;NEUT;SG	on|verstand|ig
onvertaalbaar	ADJ;INDF;NEUT;SG	on|ver|taal|baar
onverteerbaar	ADJ;INDF;NEUT;SG	on|ver|teer|baar
onvervaard	ADJ;INDF;NEUT;SG	on|vervaard
onverwacht	ADJ;INDF;NEUT;SG	on|verwacht
onverzadigbaar	ADJ;INDF;NEUT;SG	on|verzadig|baar
onverzettelijk	ADJ;INDF;NEUT;SG	on|ver|zett|elijk
onvoltooid	ADJ;INDF;NEUT;SG	on|voltooid
onvoorbereid	ADJ;INDF;NEUT;SG	on|voorbereid
onvoordelig	ADJ;INDF;NEUT;SG	on|voor|del|ig
onvoorspelbaar	ADJ;INDF;NEUT;SG	on|voor|spel|baar
onvoorwaardelijk	ADJ;INDF;NEUT;SG	on|voorwaarde|lijk
onvoorzichtig	ADJ;INDF;NEUT;SG	on|voorzichtig
onvriendelijk	ADJ;INDF;NEUT;SG	on|vriend|elijk
onvruchtbaar	ADJ;INDF;NEUT;SG	on|vrucht|baar
onwaar	ADJ;INDF;NEUT;SG	on|waar
onwaarschijnlijk	ADJ;INDF;NEUT;SG	on|waarschijnlijk
onwel	ADJ;INDF;NEUT;SG	on|wel
onwelvoeglijk	ADJ;INDF;NEUT;SG	on|wel|voeg|lijk
onweer	V;IND;PRS;1;SG	on|weer
onwerkelijk	ADJ;INDF;NEUT;SG	on|werkelijk
onwettelijk	ADJ;INDF;NEUT;SG	on|wett|elijk
onwettig	ADJ;INDF;NEUT;SG	on|wett|ig
onwillekeurig	ADJ;INDF;NEUT;SG	on|willekeur|ig
onzeker	ADJ;INDF;NEUT;SG	on|zeker
onzichtbaar	ADJ;INDF;NEUT;SG	on|zichtbaar
onzinnig	ADJ;INDF;NEUT;SG	on|zinn|ig
onzorgvuldig	ADJ;INDF;NEUT;SG	on|zorgvuldig
onzuiver	ADJ;INDF;NEUT;SG	on|zuiver
oogsten	V;SBJV;PRS;PL	oogst|en
oogst	V;IND;PRS;3;SG	oogst
oordeel	V;IND;PRS;1;SG	oor|deel
oorlogszuchtig	ADJ;INDF;NEUT;SG	oorlog|s|zucht|ig
oorlogvoerend	ADJ;INDF;NEUT;SG	oorlog|voer|end
oorspronkelijk	ADJ;INDF;NEUT;SG	oorspronk|elijk
oorveeg	V;IND;PRS;1;SG	oor|veeg
oostelijk	ADJ;INDF;NEUT;SG	oost|elijk
oostwaarts	ADJ;INDF;NEUT;SG	oost|waarts
ootmoedig	ADJ;INDF;NEUT;SG	ootmoed|ig
openen	V;SBJV;PRS;PL	openen
open	ADJ;INDF;PL	open
opener	ADJ;INDF;PL;CMPR	open|er
oplosbaar	ADJ;INDF;NEUT;SG	op|los|baar
opmerkelijk	ADJ;INDF;NEUT;SG	op|merk|elijk
opperbest	ADJ;INDF;NEUT;SG	opper|best
oppervlakkig	ADJ;INDF;NEUT;SG	opper|vlakk|ig
opstandig	ADJ;INDF;NEUT;SG	opstand|ig
optimaliseren	V;SBJV;PRS;PL	optim|al|iser|en
optimistisch	ADJ;INDF;NEUT;SG	optimist|isch
opvoedkundig	ADJ;INDF;NEUT;SG	op|voed|kund|ig
opwaarts	ADJ;INDF;NEUT;SG	op|waarts
ordelijk	ADJ;INDF;NEUT;SG	orde|lijk
ordenen	V;SBJV;PRS;PL	ordenen
organisch	ADJ;INDF;NEUT;SG	organ|isch
organiseren	V;SBJV;PRS;PL	organ|iser|en
orgelen	V;SBJV;PRS;PL	orgel|en
orgel	V;IND;PRS;1;SG	orgel
origineel	ADJ;INDF;NEUT;SG	origin|eel
ouderloos	ADJ;INDF;NEUT;SG	ouder|loos
oud	ADJ;INDF;NEUT;SG	oud
overbelasten	V;SBJV;PRS;PL	over|be|last|en
overdadig	ADJ;INDF;NEUT;SG	overdad|ig
overdekken	V;SBJV;PRS;PL	over|dekk|en
overdek	V;IND;PRS;1;SG	over|dek
overdenken	V;SBJV;PRS;PL	over|denk|en
overdrachtelijk	ADJ;INDF;NEUT;SG	overdracht|elijk
overduidelijk	ADJ;INDF;NEUT;SG	over|duid|elijk
overeenkomstig	ADJ;INDF;NEUT;SG	overeen|kom|st|ig
overeten	V;SBJV;PRS;PL	over|et|en
overheersen	V;SBJV;PRS;PL	over|heers|en
overig	ADJ;INDF;NEUT;SG	over|ig
overleven	V;SBJV;PRS;PL	over|leven
overlijden	V;SBJV;PRS;PL	over|lijd|en
overmatig	ADJ;INDF;NEUT;SG	over|mat|ig
overmoedig	ADJ;INDF;NEUT;SG	over|moed|ig
overnachten	V;SBJV;PRS;PL	over|nacht|en
overschrijden	V;SBJV;PRS;PL	over|schrijd|en
overslaan	V;SBJV;PRS;PL	over|slaa|n
overspoelen	V;SBJV;PRS;PL	over|spoel|en
overstelpen	V;SBJV;PRS;PL	over|stelp|en
overstijgen	V;SBJV;PRS;PL	over|stijg|en
overtreffen	V;SBJV;PRS;PL	over|treff|en
overvloedig	ADJ;INDF;NEUT;SG	over|vloed|ig
overvol	ADJ;INDF;NEUT;SG	over|vol
overwegen	V;SBJV;PRS;PL	over|weg|en
overwelven	V;SBJV;PRS;PL	over|welven
overwinnen	V;SBJV;PRS;PL	over|winnen
overzees	ADJ;INDF;NEUT;SG	over|zee|s
overzichtelijk	ADJ;INDF;NEUT;SG	overzicht|elijk
pachten	V;SBJV;PRS;PL	pacht|en
pacht	V;IND;PRS;3;SG	pacht
paniekerig	ADJ;INDF;NEUT;SG	pan|iek|erig
paradoxaal	ADJ;INDF;NEUT;SG	paradox|aal
paar	V;IND;PRS;1;SG	paar
paren	V;SBJV;PRS;PL	par|en
parkachtig	ADJ;INDF;NEUT;SG	park|achtig
parmantig	ADJ;INDF;NEUT;SG	parmant|ig
particulier	ADJ;INDF;NEUT;SG	particulier
particuliere	ADJ;INDF;PL	particulier|e
pasklaar	ADJ;INDF;NEUT;SG	pas|klaar
patriarchaal	ADJ;INDF;NEUT;SG	patriarch|aal
pauselijk	ADJ;INDF;NEUT;SG	paus|elijk
pauzeren	V;SBJV;PRS;PL	pauz|er|en
pederastisch	ADJ;INDF;NEUT;SG	pederast|isch
peervormig	ADJ;INDF;NEUT;SG	peer|vorm|ig
peilen	V;SBJV;PRS;PL	peil|en
peil	V;IND;PRS;1;SG	peil
peinzen	V;SBJV;PRS;PL	peinzen
pekelen	V;SBJV;PRS;PL	pekel|en
pekel	V;IND;PRS;1;SG	pekel
pellen	V;SBJV;PRS;PL	pell|en
pel	V;IND;PRS;1;SG	pel
pendelen	V;SBJV;PRS;PL	pendel|en
pendel	V;IND;PRS;1;SG	pendel
peperduur	ADJ;INDF;NEUT;SG	peper|duur
perfectioneren	V;SBJV;PRS;PL	perfect|ioner|en
periodiek	ADJ;INDF;NEUT;SG	period|iek
persoonlijk	ADJ;INDF;NEUT;SG	persoon|lijk
pesten	V;SBJV;PRS;PL	pest|en
pest	V;IND;PRS;3;SG	pest
peuteren	V;SBJV;PRS;PL	peuter|en
peuter	V;IND;PRS;1;SG	peuter
peuzelen	V;SBJV;PRS;PL	peuzel|en
peuzel	V;IND;PRS;1;SG	peuzel
pees	V;IND;PRS;1;SG	pees
pezen	V;SBJV;PRS;PL	pezen
pieken	V;SBJV;PRS;PL	piek|en
piek	V;IND;PRS;1;SG	piek
piekeren	V;SBJV;PRS;PL	pieker|en
piekerig	ADJ;INDF;NEUT;SG	piek|erig
piemelnaakt	ADJ;INDF;NEUT;SG	piemel|naakt
piepen	V;SBJV;PRS;PL	piep|en
piep	ADJ;INDF;NEUT;SG	piep
pieren	V;SBJV;PRS;PL	pier|en
pier	V;IND;PRS;1;SG	pier
pijnlijk	ADJ;INDF;NEUT;SG	pijn|lijk
pijnloos	ADJ;INDF;NEUT;SG	pijn|loos
pijpen	V;SBJV;PRS;PL	pijp|en
pijp	V;IND;PRS;1;SG	pijp
pikant	ADJ;INDF;NEUT;SG	pik|ant
pikzwart	ADJ;INDF;NEUT;SG	pik|zwart
pipetteren	V;SBJV;PRS;PL	pipet|ter|en
piramidaal	ADJ;INDF;NEUT;SG	piramid|aal
pisnijdig	ADJ;INDF;NEUT;SG	pis|nijd|ig
pissen	V;SBJV;PRS;PL	piss|en
pis	V;IND;PRS;1;SG	pis
pittig	ADJ;INDF;NEUT;SG	pitt|ig
plaatselijk	ADJ;INDF;NEUT;SG	plaats|elijk
plaatsen	V;SBJV;PRS;PL	plaats|en
plaats	V;IND;PRS;1;SG	plaats
plaatsvervangend	ADJ;INDF;NEUT;SG	plaats|vervangend
plaag	V;IND;PRS;1;SG	plaag
plagen	V;SBJV;PRS;PL	plag|en
planetair	ADJ;INDF;NEUT;SG	planet|air
planken	ADJ;INDF;PL	plank|en
planmatig	ADJ;INDF;NEUT;SG	plan|matig
plantaardig	ADJ;INDF;NEUT;SG	plant|aard|ig
planten	V;SBJV;PRS;PL	plant|en
plant	V;IND;PRS;3;SG	plant
plassen	V;SBJV;PRS;PL	plass|en
plas	V;IND;PRS;1;SG	plas
plaveien	V;SBJV;PRS;PL	plavei|en
plavei	V;IND;PRS;1;SG	plavei
plens	V;IND;PRS;1;SG	plens
plenzen	V;SBJV;PRS;PL	plenzen
pleuren	V;SBJV;PRS;PL	pleur|en
plezierig	ADJ;INDF;NEUT;SG	plezier|ig
ploegen	V;SBJV;PRS;PL	ploeg|en
ploeg	V;IND;PRS;1;SG	ploeg
ploeteren	V;SBJV;PRS;PL	ploeter|en
ploffen	V;SBJV;PRS;PL	ploff|en
plof	V;IND;PRS;1;SG	plof
plomp	ADJ;INDF;NEUT;SG	plomp
plooibaar	ADJ;INDF;NEUT;SG	plooi|baar
plooien	V;SBJV;PRS;PL	plooi|en
plooi	V;IND;PRS;1;SG	plooi
plotten	V;SBJV;PST;PL	plott|en
plot	V;IND;PRS;3;SG	plot
pluchen	ADJ;INDF;PL	pluch|en
pluche	ADJ;INDF;PL	pluche
gepluimd	V.PTCP;PST	ge|pluim|d
pluimen	V;SBJV;PRS;PL	pluim|en
pluim	V;IND;PRS;1;SG	pluim
plukken	V;SBJV;PRS;PL	plukk|en
pluk	V;IND;PRS;1;SG	pluk
plunderen	V;SBJV;PRS;PL	plunder|en
pochen	V;SBJV;PRS;PL	poch|en
poetsen	V;SBJV;PRS;PL	poets|en
poets	V;IND;PRS;1;SG	poets
pogen	V;SBJV;PRS;PL	pog|en
pokeren	V;SBJV;PRS;PL	poker|en
poker	V;IND;PRS;1;SG	poker
polariseren	V;SBJV;PRS;PL	polar|iser|en
pompen	V;SBJV;PRS;PL	pomp|en
pomp	V;IND;PRS;1;SG	pomp
popelen	V;SBJV;PRS;PL	popel|en
popel	V;IND;PRS;1;SG	popel
porren	V;SBJV;PRS;PL	porr|en
port	V;IND;PRS;3;SG	port
por	V;IND;PRS;1;SG	por
portretteren	V;SBJV;PRS;PL	portret|ter|en
poseren	V;SBJV;PRS;PL	pos|er|en
posten	V;SBJV;PRS;PL	post|en
post	V;IND;PRS;3;SG	post
poot	V;IND;PRS;3;SG	poot
poten	V;SBJV;PRS;PL	pot|en
potentieel	ADJ;INDF;NEUT;SG	potent|ieel
potig	ADJ;INDF;NEUT;SG	pot|ig
potten	V;SBJV;PST;PL	pott|en
pot	V;IND;PRS;3;SG	pot
prachtig	ADJ;INDF;NEUT;SG	pracht|ig
gepraat	V.PTCP;PST	ge|praat
praat	V;IND;PRS;3;SG	praat
praten	V;SBJV;PRS;PL	prat|en
prat	ADJ;INDF;NEUT;SG	prat
prediken	V;SBJV;PRS;PL	predik|en
preek	V;IND;PRS;1;SG	preek
preken	V;SBJV;PRS;PL	prek|en
prettig	ADJ;INDF;NEUT;SG	prett|ig
preuts	ADJ;INDF;NEUT;SG	preuts
priesterlijk	ADJ;INDF;NEUT;SG	priester|lijk
prikkelbaar	ADJ;INDF;NEUT;SG	prikkel|baar
prikken	V;SBJV;PRS;PL	prikk|en
prik	V;IND;PRS;1;SG	prik
pril	ADJ;INDF;NEUT;SG	pril
principieel	ADJ;INDF;NEUT;SG	princip|ieel
prinsheerlijk	ADJ;INDF;NEUT;SG	prins|heer|lijk
printen	V;SBJV;PRS;PL	print|en
print	V;IND;PRS;3;SG	print
problematiek	ADJ;INDF;NEUT;SG	problem|ati|ek
problematisch	ADJ;INDF;NEUT;SG	problem|atisch
proesten	V;SBJV;PRS;PL	proest|en
programmeren	V;SBJV;PRS;PL	program|mer|en
projecteren	V;SBJV;PRS;PL	project|er|en
proper	ADJ;INDF;NEUT;SG	proper
proportioneel	ADJ;INDF;NEUT;SG	proport|ioneel
proppen	V;SBJV;PRS;PL	propp|en
prop	V;IND;PRS;1;SG	prop
provinciaal	ADJ;INDF;NEUT;SG	provinci|aal
prutsen	V;SBJV;PRS;PL	pruts|en
pruts	V;IND;PRS;1;SG	pruts
pruttelen	V;SBJV;PRS;PL	pruttel|en
puber	V;IND;PRS;1;SG	puber
puffen	V;SBJV;PRS;PL	puff|en
puf	V;IND;PRS;1;SG	puf
pulsen	V;SBJV;PRS;PL	puls|en
puls	V;IND;PRS;1;SG	puls
puntgaaf	ADJ;INDF;NEUT;SG	punt|gaaf
puntig	ADJ;INDF;NEUT;SG	punt|ig
putten	V;SBJV;PST;PL	putt|en
put	V;IND;PRS;3;SG	put
puur	ADJ;INDF;NEUT;SG	puur
raadplegen	V;SBJV;PRS;PL	raad|pleg|en
raadselachtig	ADJ;INDF;NEUT;SG	raad|sel|achtig
raak	V;IND;PRS;1;SG	raak
raar	ADJ;INDF;NEUT;SG	raar
raaskallen	V;SBJV;PRS;PL	raas|kall|en
racen	V;SBJV;PRS;PL	race|n
race	V;SBJV;PRS;SG	race
racistisch	ADJ;INDF;NEUT;SG	racist|isch
radicaal	ADJ;INDF;NEUT;SG	radicaal
rad	ADJ;INDF;NEUT;SG	rad
raken	V;SBJV;PRS;PL	rak|en
rammelen	V;SBJV;PRS;PL	rammel|en
rammel	V;IND;PRS;1;SG	rammel
rammen	V;SBJV;PRS;PL	ramm|en
ram	V;IND;PRS;1;SG	ram
rangschikken	V;SBJV;PRS;PL	rang|schikk|en
ransig	ADJ;INDF;NEUT;SG	rans|ig
rantsoeneren	V;SBJV;PRS;PL	rantsoen|er|en
ranzig	ADJ;INDF;NEUT;SG	ranz|ig
raap	V;IND;PRS;1;SG	raap
rapen	V;SBJV;PRS;PL	rap|en
rapte	V;SBJV;PST;SG	rap|te
rap	V;IND;PRS;1;SG	rap
rapporteren	V;SBJV;PRS;PL	rapport|er|en
rasecht	ADJ;INDF;NEUT;SG	ras|echt
raspen	V;SBJV;PRS;PL	rasp|en
rasp	V;IND;PRS;1;SG	rasp
ratelen	V;SBJV;PRS;PL	ratel|en
ratel	V;IND;PRS;1;SG	ratel
rauw	ADJ;INDF;NEUT;SG	rauw
razendsnel	ADJ;INDF;NEUT;SG	razend|snel
razen	V;SBJV;PRS;PL	razen
realiseerbaar	ADJ;INDF;NEUT;SG	realiseer|baar
rechten	V;SBJV;PRS;PL	recht|en
recht	V;IND;PRS;3;SG	recht
rechter	ADJ;INDF;PL	recht|er
rechtlijnig	ADJ;INDF;NEUT;SG	recht|lijn|ig
rechtmatig	ADJ;INDF;NEUT;SG	recht|matig
rechtshandig	ADJ;INDF;NEUT;SG	rechts|hand|ig
rechtstreeks	ADJ;INDF;NEUT;SG	recht|streek|s
reciteren	V;SBJV;PRS;PL	recit|er|en
reconstrueren	V;SBJV;PRS;PL	re|construer|en
rectaal	ADJ;INDF;NEUT;SG	rect|aal
redden	V;SBJV;PST;PL	redd|en
redelijk	ADJ;INDF;NEUT;SG	rede|lijk
redeloos	ADJ;INDF;NEUT;SG	rede|loos
redeneren	V;SBJV;PRS;PL	reden|er|en
reden	V;SBJV;PRS;PL	red|en
rede	V;SBJV;PRS;SG	rede
redetwisten	V;SBJV;PRS;PL	rede|twist|en
redetwist	V;IND;PRS;3;SG	rede|twist
regelbaar	ADJ;INDF;NEUT;SG	regel|baar
regelen	V;SBJV;PRS;PL	regel|en
regel	V;IND;PRS;1;SG	regel
regelmatig	ADJ;INDF;NEUT;SG	regel|matig
regelrecht	ADJ;INDF;NEUT;SG	regel|recht
regenachtig	ADJ;INDF;NEUT;SG	regen|achtig
regenen	V;SBJV;PRS;PL	regenen
regent	V;IND;PRS;3;SG	reg|ent
regen	V;SBJV;PST;PL	regen
regionaal	ADJ;INDF;NEUT;SG	regi|onaal
rehabiliteren	V;SBJV;PRS;PL	re|habiliter|en
rein	ADJ;INDF;NEUT;SG	rein
reis	V;IND;PRS;1;SG	reis
reizen	V;SBJV;PRS;PL	reizen
rekenen	V;SBJV;PRS;PL	rekenen
rekken	V;SBJV;PRS;PL	rekk|en
rek	V;IND;PRS;1;SG	rek
relatief	ADJ;INDF;NEUT;SG	relat|ief
relativeren	V;SBJV;PRS;PL	relat|iv|er|en
rellen	V;SBJV;PRS;PL	rell|en
rel	V;IND;PRS;1;SG	rel
remonstrants	ADJ;INDF;NEUT;SG	remonstr|ant|s
reep	V;IND;PRS;1;SG	reep
repen	V;SBJV;PRS;PL	rep|en
reppen	V;SBJV;PRS;PL	repp|en
rep	V;IND;PRS;1;SG	rep
representatief	ADJ;INDF;NEUT;SG	represent|at|ief
respectabel	ADJ;INDF;NEUT;SG	respect|abel
respecteren	V;SBJV;PRS;PL	respect|er|en
respectvol	ADJ;INDF;NEUT;SG	respect|vol
resteren	V;SBJV;PRS;PL	rest|er|en
reumatisch	ADJ;INDF;NEUT;SG	reum|atisch
reusachtig	ADJ;INDF;NEUT;SG	reus|achtig
revolutionair	ADJ;INDF;NEUT;SG	revolut|ionair
richten	V;SBJV;PRS;PL	richt|en
ridderen	V;SBJV;PRS;PL	ridder|en
ridder	V;IND;PRS;1;SG	ridder
rieken	V;SBJV;PRS;PL	riek|en
riek	V;IND;PRS;1;SG	riek
roken	V;SBJV;PST;PL	rok|en
rook	V;IND;PST;3;SG	rook
rieten	ADJ;INDF;PL	riet|en
rijden	V;SBJV;PST;PL	rijd|en
rijen	V;SBJV;PRS;PL	rij|en
rij	V;IND;PRS;1;SG	rij
rijgen	V;SBJV;PRS;PL	rijg|en
rijpen	V;SBJV;PRS;PL	rijp|en
rijp	V;IND;PRS;1;SG	rijp
reet	V;IND;PST;3;SG	reet
rijten	V;SBJV;PRS;PL	rijt|en
rijst	V;IND;PRS;3;SG	rijst
rijs	V;IND;PRS;1;SG	rijs
rijzen	V;SBJV;PRS;PL	rijzen
rillen	V;SBJV;PRS;PL	rill|en
ril	V;IND;PRS;1;SG	ril
rimpelloos	ADJ;INDF;NEUT;SG	rimpel|loos
rioleren	V;SBJV;PRS;PL	riol|er|en
ritmisch	ADJ;INDF;NEUT;SG	ritm|isch
ritten	V;SBJV;PST;PL	ritt|en
rit	V;IND;PRS;3;SG	rit
ritueel	ADJ;INDF;NEUT;SG	rit|ueel
roddelen	V;SBJV;PRS;PL	roddel|en
roddel	V;IND;PRS;1;SG	roddel
roemen	V;SBJV;PRS;PL	roem|en
roem	V;IND;PRS;1;SG	roem
roemruchtig	ADJ;INDF;NEUT;SG	roemrucht|ig
roerloos	ADJ;INDF;NEUT;SG	roer|loos
roesten	V;SBJV;PRS;PL	roest|en
roest	V;IND;PRS;3;SG	roest
roestig	ADJ;INDF;NEUT;SG	roest|ig
roestvrij	ADJ;INDF;NEUT;SG	roest|vrij
rolschaatsen	V;SBJV;PRS;PL	rol|schaats|en
rolschaats	V;IND;PRS;1;SG	rol|schaats
rommelen	V;SBJV;PRS;PL	rommel|en
rommel	V;IND;PRS;1;SG	rommel
rommelig	ADJ;INDF;NEUT;SG	rommel|ig
rondborstig	ADJ;INDF;NEUT;SG	rond|borst|ig
ronselen	V;SBJV;PRS;PL	ronsel|en
roodachtig	ADJ;INDF;NEUT;SG	rood|achtig
roodgloeiend	ADJ;INDF;NEUT;SG	rood|gloeiend
roodharig	ADJ;INDF;NEUT;SG	rood|har|ig
rooien	V;SBJV;PRS;PL	rooi|en
rooie	V;SBJV;PRS;SG	roo|ie
rooi	V;IND;PRS;1;SG	rooi
roosteren	V;SBJV;PRS;PL	rooster|en
rooster	V;IND;PRS;1;SG	rooster
rossig	ADJ;INDF;NEUT;SG	ross|ig
rot	ADJ;INDF;NEUT;SG	rot
rotsachtig	ADJ;INDF;NEUT;SG	rots|achtig
rotsig	ADJ;INDF;NEUT;SG	rots|ig
rotsvast	ADJ;INDF;NEUT;SG	rots|vast
rouwen	V;SBJV;PRS;PL	rouw|en
rouw	V;IND;PRS;1;SG	rouw
ruien	V;SBJV;PRS;PL	rui|en
ruit	V;IND;PRS;3;SG	ruit
rui	V;IND;PRS;1;SG	rui
ruig	ADJ;INDF;NEUT;SG	ruig
ruiken	V;SBJV;PRS;PL	ruik|en
ruilen	V;SBJV;PRS;PL	ruil|en
ruil	V;IND;PRS;1;SG	ruil
ruim	ADJ;INDF;NEUT;SG	ruim
ruimer	ADJ;INDF;PL;CMPR	ruim|er
rukken	V;SBJV;PRS;PL	rukk|en
ruk	V;IND;PRS;1;SG	ruk
rumoerig	ADJ;INDF;NEUT;SG	rumoer|ig
runnen	V;SBJV;PRS;PL	runnen
run	V;IND;PRS;1;SG	run
rusteloos	ADJ;INDF;NEUT;SG	rust|eloos
rustig	ADJ;INDF;NEUT;SG	rust|ig
ruwen	V;SBJV;PRS;PL	ruw|en
ruw	ADJ;INDF;NEUT;SG	ruw
ruzie	V;IND;PRS;1;SG	ruzie
sabbelen	V;SBJV;PRS;PL	sabbel|en
sacherijnig	ADJ;INDF;NEUT;SG	sacherijn|ig
sappig	ADJ;INDF;NEUT;SG	sapp|ig
satanisch	ADJ;INDF;NEUT;SG	satan|isch
satiriek	ADJ;INDF;NEUT;SG	satir|iek
satirisch	ADJ;INDF;NEUT;SG	satir|isch
sceptisch	ADJ;INDF;NEUT;SG	scept|isch
schaatsen	V;SBJV;PRS;PL	schaats|en
schaats	V;IND;PRS;1;SG	schaats
schaduwen	V;SBJV;PRS;PL	schaduw|en
schaduw	V;IND;PRS;1;SG	schaduw
schaffen	V;SBJV;PRS;PL	schaff|en
schaften	V;SBJV;PRS;PL	schaft|en
schaft	V;IND;PRS;3;SG	schaft
schakelen	V;SBJV;PRS;PL	schakel|en
schakel	V;IND;PRS;1;SG	schakel
schallen	V;SBJV;PRS;PL	schall|en
schal	V;IND;PRS;1;SG	schal
schamel	ADJ;INDF;NEUT;SG	schamel
schamen	V;SBJV;PRS;PL	scham|en
schamper	ADJ;INDF;NEUT;SG	schamper
schandalig	ADJ;INDF;NEUT;SG	schandal|ig
schandelijk	ADJ;INDF;NEUT;SG	schande|lijk
schaarden	V;SBJV;PST;PL	schaard|en
schaar	V;IND;PRS;1;SG	schaar
scharen	V;SBJV;PRS;PL	schar|en
schare	V;SBJV;PRS;SG	schare
scharrelen	V;SBJV;PRS;PL	scharrel|en
scharrel	V;IND;PRS;1;SG	scharrel
scharren	V;SBJV;PRS;PL	scharr|en
schar	V;IND;PRS;1;SG	schar
schateren	V;SBJV;PRS;PL	schater|en
schaterlachen	V;SBJV;PRS;PL	schater|lach|en
schaterlach	V;IND;PRS;1;SG	schater|lach
schatplichtig	ADJ;INDF;NEUT;SG	schat|plicht|ig
schatrijk	ADJ;INDF;NEUT;SG	schat|rijk
schattig	ADJ;INDF;NEUT;SG	schatt|ig
scheidbaar	ADJ;INDF;NEUT;SG	scheid|baar
schelden	V;SBJV;PRS;PL	scheld|en
scheel	V;IND;PRS;1;SG	scheel
schelen	V;SBJV;PRS;PL	schel|en
schel	ADJ;INDF;NEUT;SG	schel
schemerig	ADJ;INDF;NEUT;SG	schemer|ig
scherpen	V;SBJV;PRS;PL	scherp|en
scherpte	V;SBJV;PST;SG	scherp|te
scherp	V;IND;PRS;1;SG	scherp
scherpzinnig	ADJ;INDF;NEUT;SG	scherp|zinn|ig
schertsen	V;SBJV;PRS;PL	scherts|en
scherts	V;IND;PRS;1;SG	scherts
schiften	V;SBJV;PRS;PL	schift|en
scheen	V;IND;PST;3;SG	scheen
schijnen	V;SBJV;PRS;PL	schijnen
schijn	V;IND;PRS;1;SG	schijn
scheet	V;IND;PST;3;SG	scheet
schijten	V;SBJV;PRS;PL	schijt|en
schijt	V;IND;PRS;3;SG	schijt
schijterig	ADJ;INDF;NEUT;SG	schijt|erig
schilderen	V;SBJV;PRS;PL	schilder|en
schilder	V;IND;PRS;1;SG	schilder
schillen	V;SBJV;PRS;PL	schill|en
schil	V;IND;PRS;1;SG	schil
schimmig	ADJ;INDF;NEUT;SG	schimm|ig
schitteren	V;SBJV;PRS;PL	schitter|en
schoeien	V;SBJV;PRS;PL	schoei|en
schoffelen	V;SBJV;PRS;PL	schoffel|en
schoffel	V;IND;PRS;1;SG	schoffel
schommelen	V;SBJV;PRS;PL	schommel|en
schommel	V;IND;PRS;1;SG	schommel
schoon	ADJ;INDF;NEUT;SG	schoon
schoppen	V;SBJV;PRS;PL	schopp|en
schop	V;IND;PRS;1;SG	schop
schor	ADJ;INDF;NEUT;SG	schor
schorre	ADJ;INDF;PL	schorr|e
schots	ADJ;INDF;NEUT;SG	schots
schraal	ADJ;INDF;NEUT;SG	schraal
schransen	V;SBJV;PRS;PL	schrans|en
schranzen	V;SBJV;PRS;PL	schranzen
schrappen	V;SBJV;PRS;PL	schrapp|en
schrap	V;IND;PRS;1;SG	schrap
schreefloos	ADJ;INDF;NEUT;SG	schreef|loos
schreeuwen	V;SBJV;PRS;PL	schreeuw|en
schreeuw	V;IND;PRS;1;SG	schreeuw
schreien	V;SBJV;PRS;PL	schrei|en
schriftelijk	ADJ;INDF;NEUT;SG	schrift|elijk
schrede	V;SBJV;PST;SG	schrede
schrijden	V;SBJV;PRS;PL	schrijd|en
schreef	V;IND;PST;3;SG	schreef
schrijven	V;SBJV;PRS;PL	schrijven
schrikwekkend	ADJ;INDF;NEUT;SG	schrik|wekk|end
schril	ADJ;INDF;NEUT;SG	schril
schrobben	V;SBJV;PRS;PL	schrobb|en
schrob	V;IND;PRS;1;SG	schrob
schroeien	V;SBJV;PRS;PL	schroei|en
schromelijk	ADJ;INDF;NEUT;SG	schrom|elijk
schromen	V;SBJV;PRS;PL	schrom|en
schroom	V;IND;PRS;1;SG	schroom
schuchter	ADJ;INDF;NEUT;SG	schuchter
schudden	V;SBJV;PST;PL	schudd|en
schuifelen	V;SBJV;PRS;PL	schuifel|en
scholen	V;SBJV;PST;PL	schol|en
school	V;IND;PST;3;SG	school
schuilen	V;SBJV;PRS;PL	schuil|en
schuinen	V;SBJV;PRS;PL	schuinen
schuin	ADJ;INDF;NEUT;SG	schuin
schuldig	ADJ;INDF;NEUT;SG	schuld|ig
schulpen	V;SBJV;PRS;PL	schulp|en
schulp	V;IND;PRS;1;SG	schulp
schuwen	V;SBJV;PRS;PL	schuw|en
schuw	ADJ;INDF;NEUT;SG	schuw
seinen	V;SBJV;PRS;PL	seinen
sein	V;IND;PRS;1;SG	sein
seksueel	ADJ;INDF;NEUT;SG	seks|ueel
selecteren	V;SBJV;PRS;PL	select|er|en
separatistisch	ADJ;INDF;NEUT;SG	separ|at|ist|isch
sereen	ADJ;INDF;NEUT;SG	sereen
serieus	ADJ;INDF;NEUT;SG	serieus
serveren	V;SBJV;PRS;PL	server|en
sfeervol	ADJ;INDF;NEUT;SG	sfeer|vol
sferisch	ADJ;INDF;NEUT;SG	sfer|isch
sidderen	V;SBJV;PRS;PL	sidder|en
sieren	V;SBJV;PRS;PL	sier|en
sier	V;IND;PRS;1;SG	sier
sierlijk	ADJ;INDF;NEUT;SG	sier|lijk
signaleren	V;SBJV;PRS;PL	signal|er|en
simpel	ADJ;INDF;NEUT;SG	simpel
simultaan	ADJ;INDF;NEUT;SG	simultaan
sinister	ADJ;INDF;NEUT;SG	sinister
sip	ADJ;INDF;NEUT;SG	sip
sissen	V;SBJV;PRS;PL	siss|en
sjoemelen	V;SBJV;PRS;PL	sjoemel|en
sjokken	V;SBJV;PRS;PL	sjokk|en
sjorren	V;SBJV;PRS;PL	sjorr|en
sjor	V;IND;PRS;1;SG	sjor
sjouwen	V;SBJV;PRS;PL	sjouw|en
sjouw	V;IND;PRS;1;SG	sjouw
skaten	V;SBJV;PRS;PL	skate|n
ski	V;IND;PRS;1;SG	ski
slaapwandelen	V;SBJV;PRS;PL	slaap|wandel|en
slabak	V;IND;PRS;1;SG	sla|bak
slachten	V;SBJV;PRS;PL	slacht|en
slacht	V;IND;PRS;3;SG	slacht
slaag	V;IND;PRS;1;SG	slaag
slagen	V;SBJV;PRS;PL	slag|en
slagvaardig	ADJ;INDF;NEUT;SG	slag|vaardig
slank	ADJ;INDF;NEUT;SG	slank
slaap	V;IND;PRS;1;SG	slaap
slapen	V;SBJV;PRS;PL	slap|en
sliepen	V;SBJV;PST;PL	sliep|en
slaperig	ADJ;INDF;NEUT;SG	slap|erig
slap	ADJ;INDF;NEUT;SG	slap
sleet	V;IND;PST;3;SG	sleet
slee	V;IND;PRS;1;SG	slee
sleets	ADJ;INDF;NEUT;SG	sleet|s
slenteren	V;SBJV;PRS;PL	slenter|en
slenter	V;IND;PRS;1;SG	slenter
sleep	V;IND;PST;3;SG	sleep
slepen	V;SBJV;PST;PL	slep|en
sleutelen	V;SBJV;PRS;PL	sleutel|en
sleutel	V;IND;PRS;1;SG	sleutel
slijmerig	ADJ;INDF;NEUT;SG	slijm|erig
slijpen	V;SBJV;PRS;PL	slijp|en
slijp	V;IND;PRS;1;SG	slijp
slijten	V;SBJV;PRS;PL	slijt|en
slikken	V;SBJV;PRS;PL	slikk|en
slik	V;IND;PRS;1;SG	slik
slim	ADJ;INDF;NEUT;SG	slim
slingeren	V;SBJV;PRS;PL	slinger|en
slinger	V;IND;PRS;1;SG	slinger
slinken	V;SBJV;PRS;PL	slink|en
slobberig	ADJ;INDF;NEUT;SG	slobber|ig
sloffen	V;SBJV;PRS;PL	sloff|en
slof	V;IND;PRS;1;SG	slof
slokken	V;SBJV;PRS;PL	slokk|en
slok	V;IND;PRS;1;SG	slok
sloom	ADJ;INDF;NEUT;SG	sloom
sloop	V;IND;PST;3;SG	sloop
slopen	V;SBJV;PST;PL	slop|en
sluik	ADJ;INDF;NEUT;SG	sluik
sluiker	ADJ;INDF;PL;CMPR	sluik|er
sluimeren	V;SBJV;PRS;PL	sluimer|en
sluimer	V;IND;PRS;1;SG	sluimer
sluipen	V;SBJV;PRS;PL	sluip|en
sluip	V;IND;PRS;1;SG	sluip
sloot	V;IND;PST;3;SG	sloot
sloten	V;SBJV;PST;PL	slot|en
sluiten	V;SBJV;PRS;PL	sluit|en
sluis	V;IND;PRS;1;SG	sluis
sluizen	V;SBJV;PRS;PL	sluizen
slungelachtig	ADJ;INDF;NEUT;SG	slungel|achtig
sluw	ADJ;INDF;NEUT;SG	sluw
smaakvol	ADJ;INDF;NEUT;SG	smaak|vol
smachten	V;SBJV;PRS;PL	smacht|en
smacht	V;IND;PRS;3;SG	smacht
smadelijk	ADJ;INDF;NEUT;SG	smad|elijk
smaad	V;IND;PRS;1;SG	smaad
smaden	V;SBJV;PRS;PL	smad|en
smakelijk	ADJ;INDF;NEUT;SG	smak|elijk
smakeloos	ADJ;INDF;NEUT;SG	smak|eloos
smaak	V;IND;PRS;1;SG	smaak
smaken	V;SBJV;PRS;PL	smak|en
smakken	V;SBJV;PRS;PL	smakk|en
smak	V;IND;PRS;1;SG	smak
smal	ADJ;INDF;NEUT;SG	smal
smaragden	ADJ;INDF;PL	smaragd|en
smartelijk	ADJ;INDF;NEUT;SG	smart|elijk
smeden	V;SBJV;PRS;PL	smed|en
smeken	V;SBJV;PRS;PL	smek|en
smelten	V;SBJV;PRS;PL	smelt|en
smelt	V;IND;PRS;3;SG	smelt
smerig	ADJ;INDF;NEUT;SG	smer|ig
smeulen	V;SBJV;PRS;PL	smeul|en
smeet	V;IND;PST;3;SG	smeet
smijten	V;SBJV;PRS;PL	smijt|en
smikkelen	V;SBJV;PRS;PL	smikkel|en
smikkel	V;IND;PRS;1;SG	smikkel
smoes	V;IND;PRS;1;SG	smoes
smoezen	V;SBJV;PRS;PL	smoezen
smokkelen	V;SBJV;PRS;PL	smokkel|en
smokkel	V;IND;PRS;1;SG	smokkel
smoor	V;IND;PRS;1;SG	smoor
smoren	V;SBJV;PRS;PL	smor|en
smullen	V;SBJV;PRS;PL	smull|en
smul	V;IND;PRS;1;SG	smul
snack	V;IND;PRS;1;SG	snack
snakken	V;SBJV;PRS;PL	snakk|en
snak	V;IND;PRS;1;SG	snak
snappen	V;SBJV;PRS;PL	snapp|en
snap	V;IND;PRS;1;SG	snap
sneeuwen	V;SBJV;PRS;PL	sneeuw|en
sneeuw	V;IND;PRS;1;SG	sneeuw
sneeuwwit	ADJ;INDF;NEUT;SG	sneeuw|wit
snellen	V;SBJV;PRS;PL	snell|en
snel	V;IND;PRS;1;SG	snel
sneuvelen	V;SBJV;PRS;PL	sneuvel|en
snede	V;SBJV;PST;SG	snede
snijden	V;SBJV;PRS;PL	snijd|en
snikheet	ADJ;INDF;NEUT;SG	snik|heet
snikken	V;SBJV;PRS;PL	snikk|en
snik	V;IND;PRS;1;SG	snik
snoeien	V;SBJV;PRS;PL	snoei|en
snoei	V;IND;PRS;1;SG	snoei
snoepen	V;SBJV;PRS;PL	snoep|en
snoep	V;IND;PRS;1;SG	snoep
snoeren	V;SBJV;PRS;PL	snoer|en
snoer	V;IND;PRS;1;SG	snoer
snoezig	ADJ;INDF;NEUT;SG	snoez|ig
snorren	V;SBJV;PRS;PL	snorr|en
snor	V;IND;PRS;1;SG	snor
snuffen	V;SBJV;PRS;PL	snuff|en
snuf	V;IND;PRS;1;SG	snuf
snuiten	V;SBJV;PRS;PL	snuit|en
snuit	V;IND;PRS;3;SG	snuit
snuif	V;IND;PRS;1;SG	snuif
snuiven	V;SBJV;PRS;PL	snuiven
snurken	V;SBJV;PRS;PL	snurk|en
snurk	V;IND;PRS;1;SG	snurk
sober	ADJ;INDF;NEUT;SG	sober
socialistisch	ADJ;INDF;NEUT;SG	socialist|isch
soepel	ADJ;INDF;NEUT;SG	soepel
somber	ADJ;INDF;NEUT;SG	somber
soortgelijk	ADJ;INDF;NEUT;SG	soort|gelijk
spannen	V;SBJV;PRS;PL	spannen
spanne	V;SBJV;PRS;SG	spanne
spant	V;IND;PRS;3;SG	spant
span	V;IND;PRS;1;SG	span
sparen	V;SBJV;PRS;PL	spar|en
spatten	V;SBJV;PST;PL	spatt|en
spat	V;IND;PRS;3;SG	spat
specialiseren	V;SBJV;PRS;PL	special|iser|en
speelbaar	ADJ;INDF;NEUT;SG	speel|baar
speels	ADJ;INDF;NEUT;SG	speel|s
spekken	V;SBJV;PRS;PL	spekk|en
spek	V;IND;PRS;1;SG	spek
spelden	V;SBJV;PST;PL	speld|en
spellen	V;SBJV;PRS;PL	spell|en
spelt	V;IND;PRS;3;SG	spelt
spel	V;IND;PRS;1;SG	spel
sperren	V;SBJV;PRS;PL	sperr|en
spetter	V;IND;PRS;1;SG	spett|er
speuren	V;SBJV;PRS;PL	speur|en
spiernaakt	ADJ;INDF;NEUT;SG	spier|naakt
spierwit	ADJ;INDF;NEUT;SG	spier|wit
spietsen	V;SBJV;PRS;PL	spiets|en
spiets	V;IND;PRS;1;SG	spiets
spijbelen	V;SBJV;PRS;PL	spijbel|en
spijkeren	V;SBJV;PRS;PL	spijker|en
spijker	V;IND;PRS;1;SG	spijker
speet	V;IND;PST;3;SG	speet
speten	V;SBJV;PST;PL	spet|en
spijten	V;SBJV;PRS;PL	spijt|en
spijt	V;IND;PRS;3;SG	spijt
spinnijdig	ADJ;INDF;NEUT;SG	spin|nijd|ig
spioneren	V;SBJV;PRS;PL	spion|er|en
spiraalvormig	ADJ;INDF;NEUT;SG	spiraal|vorm|ig
spiritueel	ADJ;INDF;NEUT;SG	spirit|ueel
spits	ADJ;INDF;NEUT;SG	spits
spleet	V;IND;PST;3;SG	spleet
splijten	V;SBJV;PRS;PL	splijt|en
splinternieuw	ADJ;INDF;NEUT;SG	splinter|nieuw
splitsen	V;SBJV;PRS;PL	splits|en
splits	V;IND;PRS;1;SG	splits
spoedig	ADJ;INDF;NEUT;SG	spoed|ig
spoken	V;SBJV;PRS;PL	spok|en
spook	V;IND;PRS;1;SG	spook
spookachtig	ADJ;INDF;NEUT;SG	spook|achtig
spoorloos	ADJ;INDF;NEUT;SG	spoor|loos
sporten	V;SBJV;PRS;PL	sport|en
sport	V;IND;PRS;3;SG	sport
spouwen	V;SBJV;PRS;PL	spouw|en
spouw	V;IND;PRS;1;SG	spouw
sprakeloos	ADJ;INDF;NEUT;SG	sprak|eloos
spreekwoordelijk	ADJ;INDF;NEUT;SG	spreek|woord|elijk
spreiden	V;SBJV;PRS;PL	spreid|en
spreken	V;SBJV;PRS;PL	sprek|en
springen	V;SBJV;PRS;PL	spring|en
spring	V;IND;PRS;1;SG	spring
sprong	V;IND;PST;3;SG	sprong
sproeien	V;SBJV;PRS;PL	sproei|en
sproei	V;IND;PRS;1;SG	sproei
sprokkelen	V;SBJV;PRS;PL	sprokkel|en
sprokkel	V;IND;PRS;1;SG	sprokkel
spruiten	V;SBJV;PRS;PL	spruit|en
spruit	V;IND;PRS;3;SG	spruit
spugen	V;SBJV;PRS;PL	spug|en
spuug	V;IND;PRS;1;SG	spuug
spuien	V;SBJV;PRS;PL	spui|en
spuit	V;IND;PRS;3;SG	spuit
spui	V;IND;PRS;1;SG	spui
spuiten	V;SBJV;PRS;PL	spuit|en
spuwen	V;SBJV;PRS;PL	spuw|en
staatkundig	ADJ;INDF;NEUT;SG	staat|kund|ig
stabiliseren	V;SBJV;PRS;PL	stabil|iser|en
staak	V;IND;PRS;1;SG	staak
staken	V;SBJV;PRS;PL	stak|en
stalen	ADJ;INDF;PL	stal|en
stallen	V;SBJV;PRS;PL	stall|en
stal	V;IND;PRS;1;SG	stal
stampen	V;SBJV;PRS;PL	stamp|en
stamp	V;IND;PRS;1;SG	stamp
gestampvoet	V.PTCP;PST	ge|stampvoet
stangen	V;SBJV;PRS;PL	stang|en
stang	V;IND;PRS;1;SG	stang
stapelen	V;SBJV;PRS;PL	stapel|en
stapel	V;IND;PRS;1;SG	stapel
stappen	V;SBJV;PRS;PL	stapp|en
stap	V;IND;PRS;1;SG	stap
stapsgewijs	ADJ;INDF;NEUT;SG	stap|s|gewijs
staart	V;IND;PRS;3;SG	staart
staar	V;IND;PRS;1;SG	staar
staren	V;SBJV;PRS;PL	star|en
star	ADJ;INDF;NEUT;SG	star
starten	V;SBJV;PRS;PL	start|en
start	V;IND;PRS;3;SG	start
statig	ADJ;INDF;NEUT;SG	stat|ig
stedelijk	ADJ;INDF;NEUT;SG	stede|lijk
stedewaarts	ADJ;INDF;NEUT;SG	stede|waarts
steigeren	V;SBJV;PRS;PL	steiger|en
steiger	V;IND;PRS;1;SG	steiger
steil	ADJ;INDF;NEUT;SG	steil
stellig	ADJ;INDF;NEUT;SG	stell|ig
stelselmatig	ADJ;INDF;NEUT;SG	stel|sel|matig
stenen	ADJ;INDF;PL	stenen
sterfelijk	ADJ;INDF;NEUT;SG	sterf|elijk
sterken	V;SBJV;PRS;PL	sterk|en
sterkte	V;SBJV;PST;SG	sterk|te
sterk	ADJ;INDF;NEUT;SG	sterk
stichtelijk	ADJ;INDF;NEUT;SG	sticht|elijk
stichten	V;SBJV;PRS;PL	sticht|en
sticht	V;IND;PRS;3;SG	sticht
stiekem	ADJ;INDF;NEUT;SG	stiekem
stift	V;IND;PRS;3;SG	stift
stijf	ADJ;INDF;NEUT;SG	stijf
stijlvol	ADJ;INDF;NEUT;SG	stijl|vol
stil	ADJ;INDF;NEUT;SG	stil
stinken	V;SBJV;PRS;PL	stink|en
stipt	ADJ;INDF;NEUT;SG	stipt
stoeien	V;SBJV;PRS;PL	stoei|en
stoelen	V;SBJV;PRS;PL	stoel|en
stoel	V;IND;PRS;1;SG	stoel
stoer	ADJ;INDF;NEUT;SG	stoer
stoffelijk	ADJ;INDF;NEUT;SG	stoff|elijk
stofferen	V;SBJV;PRS;PL	stof|fer|en
stoffig	ADJ;INDF;NEUT;SG	stoff|ig
stofzuigen	V;SBJV;PRS;PL	stof|zuig|en
stoken	V;SBJV;PRS;PL	stok|en
stokoud	ADJ;INDF;NEUT;SG	stok|oud
stokstijf	ADJ;INDF;NEUT;SG	stok|stijf
stollen	V;SBJV;PRS;PL	stoll|en
stol	V;IND;PRS;1;SG	stol
stompen	V;SBJV;PRS;PL	stomp|en
stomp	ADJ;INDF;NEUT;SG	stomp
stompzinnig	ADJ;INDF;NEUT;SG	stomp|zinn|ig
stom	ADJ;INDF;NEUT;SG	stom
storen	V;SBJV;PRS;PL	stor|en
stormachtig	ADJ;INDF;NEUT;SG	storm|achtig
storten	V;SBJV;PRS;PL	stort|en
stort	V;IND;PRS;3;SG	stort
stotteren	V;SBJV;PRS;PL	stotter|en
stoutmoedig	ADJ;INDF;NEUT;SG	stout|moed|ig
straatarm	ADJ;INDF;NEUT;SG	straat|arm
strafbaar	ADJ;INDF;NEUT;SG	straf|baar
strak	ADJ;INDF;NEUT;SG	strak
stranden	V;SBJV;PRS;PL	strand|en
strand	V;IND;PRS;1;SG	strand
strekken	V;SBJV;PRS;PL	strekk|en
strek	V;IND;PRS;1;SG	strek
strelen	V;SBJV;PRS;PL	strel|en
streven	V;SBJV;PRS;PL	streven
striemen	V;SBJV;PRS;PL	striem|en
striem	V;IND;PRS;1;SG	striem
strijdbaar	ADJ;INDF;NEUT;SG	strijd|baar
strijdvaardig	ADJ;INDF;NEUT;SG	strijd|vaardig
streek	V;IND;PST;3;SG	streek
strijken	V;SBJV;PRS;PL	strijk|en
strijk	V;IND;PRS;1;SG	strijk
strikken	V;SBJV;PRS;PL	strikk|en
strikt	ADJ;INDF;NEUT;SG	strikt
strik	V;IND;PRS;1;SG	strik
strippen	V;SBJV;PRS;PL	stripp|en
strip	V;IND;PRS;1;SG	strip
stroef	ADJ;INDF;NEUT;SG	stroef
stromen	V;SBJV;PRS;PL	strom|en
stroom	V;IND;PRS;1;SG	stroom
stroomlijn	V;IND;PRS;1;SG	stroom|lijn
structureel	ADJ;INDF;NEUT;SG	structur|eel
struinen	V;SBJV;PRS;PL	struinen
stug	ADJ;INDF;NEUT;SG	stug
stuiten	V;SBJV;PRS;PL	stuit|en
stuit	V;IND;PRS;3;SG	stuit
stuiter	V;IND;PRS;1;SG	stuit|er
stoof	V;IND;PST;3;SG	stoof
stoven	V;SBJV;PST;PL	stoven
stuiven	V;SBJV;PRS;PL	stuiven
stuntelig	ADJ;INDF;NEUT;SG	stuntel|ig
stunten	V;SBJV;PRS;PL	stunt|en
stunt	V;IND;PRS;3;SG	stunt
stuwen	V;SBJV;PRS;PL	stuw|en
stuw	V;IND;PRS;1;SG	stuw
subatomair	ADJ;INDF;NEUT;SG	sub|atomair
subjectief	ADJ;INDF;NEUT;SG	subject|ief
subtropisch	ADJ;INDF;NEUT;SG	sub|trop|isch
succesvol	ADJ;INDF;NEUT;SG	succes|vol
sudderen	V;SBJV;PRS;PL	sudder|en
suf	ADJ;INDF;NEUT;SG	suf
suffer	ADJ;INDF;PL;CMPR	suff|er
suizen	V;SBJV;PRS;PL	suizen
surfen	V;SBJV;PRS;PL	surf|en
swingen	V;SBJV;PRS;PL	swing|en
swing	V;IND;PRS;1;SG	swing
symbolisch	ADJ;INDF;NEUT;SG	symbol|isch
symboliseren	V;SBJV;PRS;PL	symbol|iser|en
symptomatisch	ADJ;INDF;NEUT;SG	symptom|atisch
synchroniseren	V;SBJV;PRS;PL	synchron|iser|en
synthetisch	ADJ;INDF;NEUT;SG	synthet|isch
taalkundig	ADJ;INDF;NEUT;SG	taal|kund|ig
tactvol	ADJ;INDF;NEUT;SG	tact|vol
tafelen	V;SBJV;PRS;PL	tafel|en
tafel	V;IND;PRS;1;SG	tafel
talentvol	ADJ;INDF;NEUT;SG	talent|vol
talloos	ADJ;INDF;NEUT;SG	tal|loos
talrijk	ADJ;INDF;NEUT;SG	tal|rijk
tanken	V;SBJV;PRS;PL	tank|en
tank	V;IND;PRS;1;SG	tank
taps	ADJ;INDF;NEUT;SG	tap|s
tarten	V;SBJV;PRS;PL	tart|en
tastbaar	ADJ;INDF;NEUT;SG	tast|baar
tasten	V;SBJV;PRS;PL	tast|en
tast	V;IND;PRS;3;SG	tast
teder	ADJ;INDF;NEUT;SG	teder
tegendraads	ADJ;INDF;NEUT;SG	tegen|draad|s
tegenstrijdig	ADJ;INDF;NEUT;SG	tegen|strijd|ig
teisteren	V;SBJV;PRS;PL	teister|en
telbaar	ADJ;INDF;NEUT;SG	tel|baar
telefoneren	V;SBJV;PRS;PL	telefon|er|en
telen	V;SBJV;PRS;PL	tel|en
teem	V;IND;PRS;1;SG	teem
temen	V;SBJV;PRS;PL	tem|en
tendentieus	ADJ;INDF;NEUT;SG	tendent|ieus
tenger	ADJ;INDF;NEUT;SG	tenger
tennissen	V;SBJV;PRS;PL	tenniss|en
tennis	V;IND;PRS;1;SG	tennis
terecht	ADJ;INDF;NEUT;SG	te|recht
terloops	ADJ;INDF;NEUT;SG	ter|loop|s
territoriaal	ADJ;INDF;NEUT;SG	territori|aal
terroristisch	ADJ;INDF;NEUT;SG	terrorist|isch
testamentair	ADJ;INDF;NEUT;SG	testament|air
testen	V;SBJV;PRS;PL	test|en
test	V;IND;PRS;3;SG	test
textiel	ADJ;INDF;NEUT;SG	textiel
theatraal	ADJ;INDF;NEUT;SG	theatr|aal
theoretisch	ADJ;INDF;NEUT;SG	theore|tisch
tienjarig	ADJ;INDF;NEUT;SG	tien|jar|ig
tieren	V;SBJV;PRS;PL	tier|en
tier	V;IND;PRS;1;SG	tier
tijdig	ADJ;INDF;NEUT;SG	tijd|ig
tilde	V;SBJV;PST;SG	tilde
tillen	V;SBJV;PRS;PL	till|en
tilt	V;IND;PRS;3;SG	tilt
til	V;IND;PRS;1;SG	til
tinten	V;SBJV;PRS;PL	tint|en
tint	V;IND;PRS;3;SG	tint
tippelen	V;SBJV;PRS;PL	tippel|en
tippel	V;IND;PRS;1;SG	tippel
tippen	V;SBJV;PRS;PL	tipp|en
tip	V;IND;PRS;1;SG	tip
tiranniek	ADJ;INDF;NEUT;SG	tirann|iek
tochtig	ADJ;INDF;NEUT;SG	tocht|ig
toegankelijk	ADJ;INDF;NEUT;SG	toe|gank|elijk
toekomstig	ADJ;INDF;NEUT;SG	toe|kom|st|ig
toepasselijk	ADJ;INDF;NEUT;SG	toe|pass|elijk
toeristisch	ADJ;INDF;NEUT;SG	toer|ist|isch
toetsen	V;SBJV;PRS;PL	toets|en
toets	V;IND;PRS;1;SG	toets
toevallig	ADJ;INDF;NEUT;SG	toevall|ig
tof	ADJ;INDF;NEUT;SG	tof
tolerabel	ADJ;INDF;NEUT;SG	toler|abel
tolerant	ADJ;INDF;NEUT;SG	toler|ant
tolken	V;SBJV;PRS;PL	tolk|en
tolk	V;IND;PRS;1;SG	tolk
tomeloos	ADJ;INDF;NEUT;SG	tom|eloos
tongzoen	V;IND;PRS;1;SG	tong|zoen
toornig	ADJ;INDF;NEUT;SG	toorn|ig
toosten	V;SBJV;PRS;PL	toost|en
toost	V;IND;PRS;3;SG	toost
totaal	ADJ;INDF;NEUT;SG	totaal
toveren	V;SBJV;PRS;PL	tover|en
toxicologisch	ADJ;INDF;NEUT;SG	toxicolog|isch
traag	ADJ;INDF;NEUT;SG	traag
trachten	V;SBJV;PRS;PL	tracht|en
traditioneel	ADJ;INDF;NEUT;SG	tradit|ioneel
tralie	V;IND;PRS;1;SG	tralie
traan	V;IND;PRS;1;SG	traan
tranen	V;SBJV;PRS;PL	tranen
transitief	ADJ;INDF;NEUT;SG	transit|ief
transporteren	V;SBJV;PRS;PL	transport|er|en
transseksueel	ADJ;INDF;NEUT;SG	trans|seks|ueel
traumatisch	ADJ;INDF;NEUT;SG	traum|atisch
trefzeker	ADJ;INDF;NEUT;SG	tref|zeker
treiteren	V;SBJV;PRS;PL	treiter|en
treiter	V;IND;PRS;1;SG	treiter
treuren	V;SBJV;PRS;PL	treur|en
triest	ADJ;INDF;NEUT;SG	triest
trillen	V;SBJV;PRS;PL	trill|en
tril	V;IND;PRS;1;SG	tril
trimmen	V;SBJV;PRS;PL	trimm|en
triomfant	ADJ;INDF;NEUT;SG	triomf|ant
triomferen	V;SBJV;PRS;PL	triomf|er|en
troebel	ADJ;INDF;NEUT;SG	troebel
tronen	V;SBJV;PRS;PL	tronen
troon	V;IND;PRS;1;SG	troon
troosten	V;SBJV;PRS;PL	troost|en
troost	V;IND;PRS;3;SG	troost
tropisch	ADJ;INDF;NEUT;SG	trop|isch
trots	ADJ;INDF;NEUT;SG	trots
tuinier	V;IND;PRS;1;SG	tuin|ier
tuiten	V;SBJV;PRS;PL	tuit|en
tuit	V;IND;PRS;3;SG	tuit
turen	V;SBJV;PRS;PL	tur|en
turf	V;IND;PRS;1;SG	turf
turven	V;SBJV;PRS;PL	turven
tussentijds	ADJ;INDF;NEUT;SG	tussen|tijd|s
tweedehands	ADJ;INDF;NEUT;SG	twee|de|hand|s
tweeloops	ADJ;INDF;NEUT;SG	twee|loop|s
tweetalig	ADJ;INDF;NEUT;SG	twee|tal|ig
tweevoetig	ADJ;INDF;NEUT;SG	twee|voet|ig
tweevoudig	ADJ;INDF;NEUT;SG	tweevoud|ig
tweezaadlobbig	ADJ;INDF;NEUT;SG	twee|zaad|lobb|ig
twijfelachtig	ADJ;INDF;NEUT;SG	twijfel|achtig
twijfelen	V;SBJV;PRS;PL	twijfel|en
twijfel	V;IND;PRS;1;SG	twijfel
twinkelen	V;SBJV;PRS;PL	twinkel|en
uiteindelijk	ADJ;INDF;NEUT;SG	uit|einde|lijk
uiten	V;SBJV;PRS;PL	uit|en
uit	V;IND;PRS;3;SG	uit
uitheems	ADJ;INDF;NEUT;SG	uit|heem|s
uitneembaar	ADJ;INDF;NEUT;SG	uit|neem|baar
uitvoerbaar	ADJ;INDF;NEUT;SG	uit|voer|baar
uitzichtloos	ADJ;INDF;NEUT;SG	uit|zicht|loos
uitzonderlijk	ADJ;INDF;NEUT;SG	uitzonder|lijk
vaag	V;IND;PRS;1;SG	vaag
vaal	ADJ;INDF;NEUT;SG	vaal
vaderlijk	ADJ;INDF;NEUT;SG	vader|lijk
vaderloos	ADJ;INDF;NEUT;SG	vader|loos
vagen	V;SBJV;PRS;PL	vag|en
vaginaal	ADJ;INDF;NEUT;SG	vagin|aal
vakkundig	ADJ;INDF;NEUT;SG	vak|kund|ig
vals	ADJ;INDF;NEUT;SG	vals
vangen	V;SBJV;PRS;PL	vang|en
vang	V;IND;PRS;1;SG	vang
vanzelfsprekend	ADJ;INDF;NEUT;SG	vanzelf|sprek|end
variabel	ADJ;INDF;NEUT;SG	vari|abel
vastberaden	ADJ;INDF;PL	vast|beraden
vatten	V;SBJV;PST;PL	vatt|en
vat	V;IND;PRS;3;SG	vat
vechten	V;SBJV;PRS;PL	vecht|en
vochten	V;SBJV;PST;PL	vocht|en
vocht	V;IND;PST;3;SG	vocht
veeleisend	ADJ;INDF;NEUT;SG	veel|eis|end
veelzijdig	ADJ;INDF;NEUT;SG	veel|zijd|ig
veeg	V;IND;PRS;1;SG	veeg
vegen	V;SBJV;PRS;PL	veg|en
veilen	V;SBJV;PRS;PL	veil|en
veil	ADJ;INDF;NEUT;SG	veil
veilig	ADJ;INDF;NEUT;SG	veilig
veiler	ADJ;INDF;PL;CMPR	veil|er
veel	V;IND;PRS;1;SG	veel
velen	V;SBJV;PRS;PL	vel|en
vellen	V;SBJV;PRS;PL	vell|en
vel	V;IND;PRS;1;SG	vel
venijnig	ADJ;INDF;NEUT;SG	venijn|ig
venten	V;SBJV;PRS;PL	vent|en
vent	V;IND;PRS;3;SG	vent
verachtelijk	ADJ;INDF;NEUT;SG	ver|acht|elijk
verachten	V;SBJV;PRS;PL	ver|acht|en
verademen	V;SBJV;PRS;PL	ver|adem|en
verafgoden	V;SBJV;PRS;PL	ver|afgod|en
verafschuwen	V;SBJV;PRS;PL	ver|afschuw|en
veranderlijk	ADJ;INDF;NEUT;SG	verander|lijk
verankeren	V;SBJV;PRS;PL	ver|anker|en
verantwoordelijk	ADJ;INDF;NEUT;SG	verantwoord|elijk
verassen	V;SBJV;PRS;PL	ver|ass|en
verbaal	ADJ;INDF;NEUT;SG	verb|aal
verbergen	V;SBJV;PRS;PL	ver|berg|en
verbeteren	V;SBJV;PRS;PL	ver|beter|en
verbeuzelen	V;SBJV;PRS;PL	ver|beuzel|en
verbijsteren	V;SBJV;PRS;PL	ver|bijster|en
verbinden	V;SBJV;PRS;PL	ver|bind|en
verbitteren	V;SBJV;PRS;PL	ver|bitter|en
verbleken	V;SBJV;PRS;PL	ver|blek|en
verblijden	V;SBJV;PRS;PL	ver|blij|den
verblijven	V;SBJV;PRS;PL	ver|blijven
verblinden	V;SBJV;PRS;PL	ver|blind|en
verbouwen	V;SBJV;PRS;PL	ver|bouw|en
verbranden	V;SBJV;PRS;PL	ver|brand|en
verbreden	V;SBJV;PRS;PL	ver|bred|en
verbreken	V;SBJV;PRS;PL	ver|brek|en
verbrijzelen	V;SBJV;PRS;PL	ver|brijzel|en
verbuigen	V;SBJV;PRS;PL	ver|buig|en
verchromen	V;SBJV;PRS;PL	ver|chrom|en
verdampen	V;SBJV;PRS;PL	ver|damp|en
verdedigbaar	ADJ;INDF;NEUT;SG	verdedig|baar
verdelen	V;SBJV;PRS;PL	ver|del|en
verdelgen	V;SBJV;PRS;PL	ver|delg|en
verdenken	V;SBJV;PRS;PL	ver|denk|en
verdichten	V;SBJV;PRS;PL	ver|dicht|en
verdienstelijk	ADJ;INDF;NEUT;SG	verdien|ste|lijk
verdiepen	V;SBJV;PRS;PL	ver|diep|en
verdikken	V;SBJV;PRS;PL	ver|dikk|en
verdoen	V;SBJV;PRS;PL	ver|doe|n
verdoezelen	V;SBJV;PRS;PL	ver|doezel|en
verdraaglijk	ADJ;INDF;NEUT;SG	ver|draag|lijk
verdraagzaam	ADJ;INDF;NEUT;SG	ver|draag|zaam
verdraaien	V;SBJV;PRS;PL	ver|draai|en
verdrietig	ADJ;INDF;NEUT;SG	verdriet|ig
verdrievoudigen	V;SBJV;PRS;PL	ver|drievoud|ig|en
verdrijven	V;SBJV;PRS;PL	ver|drijven
verdringen	V;SBJV;PRS;PL	ver|dring|en
verdrinken	V;SBJV;PRS;PL	ver|drink|en
verdrukken	V;SBJV;PRS;PL	ver|drukk|en
verdubbelen	V;SBJV;PRS;PL	ver|dubbel|en
verduidelijken	V;SBJV;PRS;PL	ver|duid|elijk|en
verduisteren	V;SBJV;PRS;PL	ver|duister|en
verdunnen	V;SBJV;PRS;PL	ver|dunnen
verdwalen	V;SBJV;PRS;PL	ver|dwal|en
veredelen	V;SBJV;PRS;PL	ver|edel|en
vereenvoudigen	V;SBJV;PRS;PL	ver|eenvoud|ig|en
vereeuwigen	V;SBJV;PRS;PL	ver|eeuw|ig|en
vereisen	V;SBJV;PRS;PL	ver|eis|en
verengelsen	V;SBJV;PRS;PL	ver|engels|en
verenigbaar	ADJ;INDF;NEUT;SG	verenig|baar
vereren	V;SBJV;PRS;PL	ver|er|en
verergeren	V;SBJV;PRS;PL	ver|erger|en
verfijnen	V;SBJV;PRS;PL	ver|fijnen
verfilmen	V;SBJV;PRS;PL	ver|film|en
verflauwen	V;SBJV;PRS;PL	ver|flauw|en
verfraaien	V;SBJV;PRS;PL	ver|fraai|en
verfrissen	V;SBJV;PRS;PL	ver|friss|en
vergankelijk	ADJ;INDF;NEUT;SG	ver|ga|nkelijk
vergaren	V;SBJV;PRS;PL	ver|gar|en
vergeeflijk	ADJ;INDF;NEUT;SG	ver|geef|lijk
vergeetachtig	ADJ;INDF;NEUT;SG	vergeet|achtig
vergelden	V;SBJV;PRS;PL	ver|geld|en
vergelen	V;SBJV;PRS;PL	ver|gel|en
vergelijkbaar	ADJ;INDF;NEUT;SG	ver|gelijk|baar
vergelijken	V;SBJV;PRS;PL	ver|gelijk|en
vergemakkelijken	V;SBJV;PRS;PL	ver|gemakk|elijk|en
vergen	V;SBJV;PRS;PL	verg|en
vergevorderd	ADJ;INDF;NEUT;SG	ver|gevorderd
vergezellen	V;SBJV;PRS;PL	ver|gezell|en
vergezocht	ADJ;INDF;NEUT;SG	ver|gezocht
vergieten	V;SBJV;PRS;PL	ver|giet|en
vergiftigen	V;SBJV;PRS;PL	ver|gift|ig|en
vergiftig	V;IND;PRS;1;SG	vergift|ig
verglijden	V;SBJV;PRS;PL	ver|glijd|en
vergoeden	V;SBJV;PRS;PL	ver|goed|en
vergooien	V;SBJV;PRS;PL	ver|gooi|en
vergrendelen	V;SBJV;PRS;PL	ver|grendel|en
vergrijpen	V;SBJV;PRS;PL	ver|grijp|en
vergrijzen	V;SBJV;PRS;PL	ver|grijzen
vergroeien	V;SBJV;PRS;PL	ver|groei|en
vergroten	V;SBJV;PRS;PL	ver|grot|en
vergunnen	V;SBJV;PRS;PL	ver|gunnen
verhalen	V;SBJV;PRS;PL	ver|hal|en
verhandelen	V;SBJV;PRS;PL	ver|handel|en
verharden	V;SBJV;PRS;PL	ver|hard|en
verharen	V;SBJV;PRS;PL	ver|har|en
verhaspelen	V;SBJV;PRS;PL	ver|haspel|en
verheerlijken	V;SBJV;PRS;PL	ver|heer|lijk|en
verheffen	V;SBJV;PRS;PL	ver|heff|en
verhelpen	V;SBJV;PRS;PL	ver|help|en
verhinderen	V;SBJV;PRS;PL	ver|hinder|en
verhitten	V;SBJV;PST;PL	ver|hitte|n
verhogen	V;SBJV;PRS;PL	ver|hog|en
verhongeren	V;SBJV;PRS;PL	ver|honger|en
verhoren	V;SBJV;PRS;PL	ver|hor|en
verhullen	V;SBJV;PRS;PL	ver|hull|en
verhuren	V;SBJV;PRS;PL	ver|hur|en
verjaren	V;SBJV;PRS;PL	ver|jar|en
verjongen	V;SBJV;PRS;PL	ver|jong|en
verkassen	V;SBJV;PRS;PL	ver|kass|en
verkeer	V;IND;PRS;1;SG	verkeer
verkeren	V;SBJV;PRS;PL	ver|ker|en
verkiesbaar	ADJ;INDF;NEUT;SG	ver|kies|baar
verkiezen	V;SBJV;PRS;PL	ver|kiezen
verklappen	V;SBJV;PRS;PL	ver|klapp|en
verklaren	V;SBJV;PRS;PL	ver|klar|en
verkleden	V;SBJV;PRS;PL	ver|kled|en
verkleinen	V;SBJV;PRS;PL	ver|kleinen
verkleuren	V;SBJV;PRS;PL	ver|kleur|en
verkloten	V;SBJV;PRS;PL	ver|klot|en
verkneukelen	V;SBJV;PRS;PL	ver|kneukel|en
verknoeien	V;SBJV;PRS;PL	ver|knoei|en
verkoelen	V;SBJV;PRS;PL	ver|koel|en
verkolen	V;SBJV;PRS;PL	ver|kol|en
verkommeren	V;SBJV;PRS;PL	ver|kommer|en
verkopen	V;SBJV;PRS;PL	ver|kop|en
verkoperen	V;SBJV;PRS;PL	ver|koper|en
verkoper	V;IND;PRS;1;SG	ver|kop|er
verkorten	V;SBJV;PRS;PL	ver|kort|en
verkreukelen	V;SBJV;PRS;PL	ver|kreukel|en
verkrijgbaar	ADJ;INDF;NEUT;SG	ver|krijg|baar
verkrijgen	V;SBJV;PRS;PL	ver|krijg|en
verkwikken	V;SBJV;PRS;PL	ver|kwikk|en
verlagen	V;SBJV;PRS;PL	ver|lag|en
verlangzamen	V;SBJV;PRS;PL	ver|langzam|en
verleidelijk	ADJ;INDF;NEUT;SG	verleid|elijk
verlenen	V;SBJV;PRS;PL	ver|lenen
verlengen	V;SBJV;PRS;PL	ver|leng|en
verlichten	V;SBJV;PRS;PL	ver|licht|en
verloederen	V;SBJV;PRS;PL	ver|loeder|en
verlokkelijk	ADJ;INDF;NEUT;SG	ver|lokk|elijk
verlokken	V;SBJV;PRS;PL	ver|lokk|en
verloochenen	V;SBJV;PRS;PL	ver|loochenen
verluchtigen	V;SBJV;PRS;PL	ver|lucht|ig|en
vermageren	V;SBJV;PRS;PL	ver|mager|en
vermaken	V;SBJV;PRS;PL	ver|mak|en
vermeerderen	V;SBJV;PRS;PL	ver|meerder|en
vermelden	V;SBJV;PRS;PL	ver|meld|en
vermengen	V;SBJV;PRS;PL	ver|meng|en
vermenigvuldigen	V;SBJV;PRS;PL	ver|menigvuldig|en
vermeten	ADJ;INDF;PL	ver|met|en
vermijden	V;SBJV;PRS;PL	ver|mijd|en
verminderen	V;SBJV;PRS;PL	ver|minder|en
vermissen	V;SBJV;PRS;PL	ver|miss|en
vermoedelijk	ADJ;INDF;NEUT;SG	vermoed|elijk
vermoeien	V;SBJV;PRS;PL	ver|moeie|n
vermolmen	V;SBJV;PRS;PL	ver|molm|en
vermommen	V;SBJV;PRS;PL	ver|momm|en
vermoorden	V;SBJV;PRS;PL	ver|moord|en
vermorsen	V;SBJV;PRS;PL	ver|mors|en
vermurwen	V;SBJV;PRS;PL	ver|murw|en
vernaaien	V;SBJV;PRS;PL	ver|naai|en
vernederlandsen	V;SBJV;PRS;PL	ver|nederlands|en
vernemen	V;SBJV;PRS;PL	ver|nem|en
verneuken	V;SBJV;PRS;PL	ver|neuk|en
vernietigen	V;SBJV;PRS;PL	ver|nietig|en
vernieuwen	V;SBJV;PRS;PL	ver|nieuw|en
vernoemen	V;SBJV;PRS;PL	ver|noem|en
vernuftig	ADJ;INDF;NEUT;SG	vernuft|ig
veronderstellen	V;SBJV;PRS;PL	ver|onder|stell|en
verontrusten	V;SBJV;PRS;PL	ver|ont|rust|en
veroordelen	V;SBJV;PRS;PL	ver|oordel|en
veroorzaken	V;SBJV;PRS;PL	ver|oorzak|en
veropenbaren	V;SBJV;PRS;PL	ver|openbar|en
verordonneren	V;SBJV;PRS;PL	ver|ordonner|en
verouderen	V;SBJV;PRS;PL	ver|ouder|en
verpanden	V;SBJV;PRS;PL	ver|pand|en
verplaatsen	V;SBJV;PRS;PL	ver|plaats|en
verplanten	V;SBJV;PRS;PL	ver|plant|en
verpletteren	V;SBJV;PRS;PL	ver|pletter|en
verplichten	V;SBJV;PRS;PL	ver|plicht|en
verpotten	V;SBJV;PST;PL	ver|pott|en
verprutsen	V;SBJV;PRS;PL	ver|pruts|en
verraderlijk	ADJ;INDF;NEUT;SG	verrad|er|lijk
verrassen	V;SBJV;PRS;PL	verrass|en
verregaand	ADJ;INDF;NEUT;SG	verr|e|gaand
verrekenen	V;SBJV;PRS;PL	ver|rekenen
verrekken	V;SBJV;PRS;PL	ver|rekk|en
verrijken	V;SBJV;PRS;PL	ver|rijk|en
verrijzen	V;SBJV;PRS;PL	ver|rijzen
verroeren	V;SBJV;PRS;PL	ver|roer|en
verroesten	V;SBJV;PRS;PL	ver|roest|en
verrotten	V;SBJV;PST;PL	ver|rott|en
verrukkelijk	ADJ;INDF;NEUT;SG	ver|rukk|elijk
verrukken	V;SBJV;PRS;PL	ver|rukk|en
verschaffen	V;SBJV;PRS;PL	ver|schaff|en
verschansen	V;SBJV;PRS;PL	ver|schans|en
verschepen	V;SBJV;PRS;PL	ver|schep|en
verscheuren	V;SBJV;PRS;PL	ver|scheur|en
verschieten	V;SBJV;PRS;PL	ver|schiet|en
verschonen	V;SBJV;PRS;PL	ver|schonen
verschrijven	V;SBJV;PRS;PL	ver|schrijven
verschrikkelijk	ADJ;INDF;NEUT;SG	ver|schrikk|elijk
verschrikken	V;SBJV;PRS;PL	ver|schrikk|en
verschroeien	V;SBJV;PRS;PL	ver|schroei|en
verschuilen	V;SBJV;PRS;PL	ver|schuil|en
verschuiven	V;SBJV;PRS;PL	ver|schuiven
versieren	V;SBJV;PRS;PL	ver|sier|en
versimpelen	V;SBJV;PRS;PL	ver|simpel|en
verslaan	V;SBJV;PRS;PL	ver|slaa|n
verslechteren	V;SBJV;PRS;PL	ver|slechter|en
verslijten	V;SBJV;PRS;PL	ver|slijt|en
verslikken	V;SBJV;PRS;PL	ver|slikk|en
versmallen	V;SBJV;PRS;PL	ver|small|en
versmelten	V;SBJV;PRS;PL	ver|smelt|en
versnellen	V;SBJV;PRS;PL	ver|snell|en
versnipperen	V;SBJV;PRS;PL	ver|snipper|en
versoepelen	V;SBJV;PRS;PL	ver|soepel|en
versomberen	V;SBJV;PRS;PL	ver|somber|en
versperren	V;SBJV;PRS;PL	ver|sperr|en
verspillen	V;SBJV;PRS;PL	ver|spill|en
verspreiden	V;SBJV;PRS;PL	ver|spreid|en
verstandelijk	ADJ;INDF;NEUT;SG	verstand|elijk
verstandig	ADJ;INDF;NEUT;SG	verstand|ig
verstarren	V;SBJV;PRS;PL	ver|starr|en
verstellen	V;SBJV;PRS;PL	ver|stell|en
versterken	V;SBJV;PRS;PL	ver|sterk|en
verstijven	V;SBJV;PRS;PL	ver|stijven
verstikken	V;SBJV;PRS;PL	ver|stikk|en
verstoppen	V;SBJV;PRS;PL	ver|stopp|en
verstoren	V;SBJV;PRS;PL	ver|stor|en
verstrammen	V;SBJV;PRS;PL	ver|stramm|en
verstrekken	V;SBJV;PRS;PL	ver|strekk|en
verstrijken	V;SBJV;PRS;PL	ver|strijk|en
verstrikken	V;SBJV;PRS;PL	ver|strikk|en
versturen	V;SBJV;PRS;PL	ver|stur|en
vertaalbaar	ADJ;INDF;NEUT;SG	ver|taal|baar
vertakken	V;SBJV;PRS;PL	ver|takk|en
vertalen	V;SBJV;PRS;PL	ver|tal|en
verteerbaar	ADJ;INDF;NEUT;SG	ver|teer|baar
verteren	V;SBJV;PRS;PL	ver|ter|en
vertikken	V;SBJV;PRS;PL	ver|tikk|en
vertoeven	V;SBJV;PRS;PL	ver|toeven
vertonen	V;SBJV;PRS;PL	ver|tonen
vertragen	V;SBJV;PRS;PL	ver|trag|en
vertrekken	V;SBJV;PRS;PL	ver|trekk|en
vertroosten	V;SBJV;PRS;PL	ver|troost|en
vervaarlijk	ADJ;INDF;NEUT;SG	vervaar|lijk
vervagen	V;SBJV;PRS;PL	ver|vag|en
vervalsen	V;SBJV;PRS;PL	ver|vals|en
vervangbaar	ADJ;INDF;NEUT;SG	vervang|baar
vervellen	V;SBJV;PRS;PL	ver|vell|en
verf	V;IND;PRS;1;SG	verf
verven	V;SBJV;PRS;PL	verven
ver	ADJ;INDF;NEUT;SG	ver
verversen	V;SBJV;PRS;PL	ver|vers|en
vervliegen	V;SBJV;PRS;PL	ver|vlieg|en
vervoegen	V;SBJV;PRS;PL	ver|voeg|en
vervoeren	V;SBJV;PRS;PL	ver|voer|en
vervolgen	V;SBJV;PRS;PL	ver|volg|en
vervormen	V;SBJV;PRS;PL	ver|vorm|en
vervreemden	V;SBJV;PRS;PL	ver|vreemd|en
vervroegen	V;SBJV;PRS;PL	ver|vroeg|en
vervuilen	V;SBJV;PRS;PL	ver|vuil|en
vervullen	V;SBJV;PRS;PL	ver|vull|en
verwaarloosbaar	ADJ;INDF;NEUT;SG	ver|waarloos|baar
verwaarlozen	V;SBJV;PRS;PL	ver|waarlozen
verwachten	V;SBJV;PRS;PL	ver|wacht|en
verwante	ADJ;INDF;PL	verwant|e
verwarmen	V;SBJV;PRS;PL	ver|warm|en
verwarren	V;SBJV;PRS;PL	ver|warr|en
verwekken	V;SBJV;PRS;PL	ver|wekk|en
verwelken	V;SBJV;PRS;PL	ver|welk|en
verwelkomen	V;SBJV;PRS;PL	ver|welkom|en
verwennen	V;SBJV;PRS;PL	ver|wennen
verwerken	V;SBJV;PRS;PL	ver|werk|en
verwerpelijk	ADJ;INDF;NEUT;SG	ver|werp|elijk
verwerpen	V;SBJV;PRS;PL	ver|werp|en
verwerven	V;SBJV;PRS;PL	ver|werven
verwezenlijken	V;SBJV;PRS;PL	ver|wezen|lijk|en
verwijden	V;SBJV;PRS;PL	ver|wijd|en
verwijderen	V;SBJV;PRS;PL	ver|wijder|en
verwijten	V;SBJV;PRS;PL	ver|wijt|en
verwijven	V;SBJV;PRS;PL	ver|wijven
verwezen	V;SBJV;PST;PL	ver|wezen
verwijzen	V;SBJV;PRS;PL	ver|wijzen
verwikkelen	V;SBJV;PRS;PL	ver|wikkel|en
verwilderen	V;SBJV;PRS;PL	ver|wilder|en
verwisselen	V;SBJV;PRS;PL	ver|wissel|en
verwoesten	V;SBJV;PRS;PL	ver|woest|en
verwonden	V;SBJV;PRS;PL	ver|wond|en
verwonderen	V;SBJV;PRS;PL	ver|wonder|en
verwoorden	V;SBJV;PRS;PL	ver|woord|en
verwringen	V;SBJV;PRS;PL	ver|wring|en
verzachten	V;SBJV;PRS;PL	ver|zacht|en
verzamelen	V;SBJV;PRS;PL	ver|zamel|en
verzegelen	V;SBJV;PRS;PL	ver|zegel|en
verzekeren	V;SBJV;PRS;PL	ver|zeker|en
verzenden	V;SBJV;PRS;PL	ver|zend|en
verzengen	V;SBJV;PRS;PL	ver|zeng|en
verzetten	V;SBJV;PST;PL	ver|zett|en
verzet	V.PTCP;PST	ver|zet
verzieken	V;SBJV;PRS;PL	ver|ziek|en
verzinnen	V;SBJV;PRS;PL	ver|zinnen
verzorgen	V;SBJV;PRS;PL	ver|zorg|en
verzuilen	V;SBJV;PRS;PL	ver|zuil|en
verzuimen	V;SBJV;PRS;PL	ver|zuim|en
verzuipen	V;SBJV;PRS;PL	ver|zuip|en
verzuren	V;SBJV;PRS;PL	ver|zur|en
verzwakken	V;SBJV;PRS;PL	ver|zwakk|en
verzwaren	V;SBJV;PRS;PL	ver|zwar|en
verzwelgen	V;SBJV;PRS;PL	ver|zwelg|en
verzwijgen	V;SBJV;PRS;PL	ver|zwijg|en
vettig	ADJ;INDF;NEUT;SG	vett|ig
vet	ADJ;INDF;NEUT;SG	vet
vierde	V;SBJV;PST;SG	vier|de
vieren	V;SBJV;PRS;PL	vier|en
vier	V;IND;PRS;1;SG	vier
vierhoekig	ADJ;INDF;NEUT;SG	vier|hoek|ig
vies	ADJ;INDF;NEUT;SG	vies
vijandelijk	ADJ;INDF;NEUT;SG	vijand|elijk
vijandig	ADJ;INDF;NEUT;SG	vijand|ig
vijfvoudig	ADJ;INDF;NEUT;SG	vijfvoud|ig
vijs	V;IND;PRS;1;SG	vijs
vijzen	V;SBJV;PRS;PL	vijzen
vinden	V;SBJV;PRS;PL	vind|en
vond	V;IND;PST;3;SG	vond
vindingrijk	ADJ;INDF;NEUT;SG	vind|ing|rijk
gevingerd	V.PTCP;PST	ge|vinger|d
vingeren	V;SBJV;PRS;PL	vinger|en
vinger	V;IND;PRS;1;SG	vinger
vinken	V;SBJV;PRS;PL	vink|en
vink	V;IND;PRS;1;SG	vink
vissen	V;SBJV;PRS;PL	viss|en
vis	V;IND;PRS;1;SG	vis
gevlamd	V.PTCP;PST	ge|vlam|d
vlammen	V;SBJV;PRS;PL	vlamm|en
vlam	V;IND;PRS;1;SG	vlam
vlaskleurig	ADJ;INDF;NEUT;SG	vlas|kleur|ig
vlechten	V;SBJV;PRS;PL	vlecht|en
vlecht	V;IND;PRS;3;SG	vlecht
vlekkeloos	ADJ;INDF;NEUT;SG	vlekk|eloos
vlezig	ADJ;INDF;NEUT;SG	vlez|ig
vlieten	V;SBJV;PRS;PL	vliet|en
vliet	V;IND;PRS;3;SG	vliet
vloot	V;IND;PST;3;SG	vloot
vlijmscherp	ADJ;INDF;NEUT;SG	vlijm|scherp
vlijtig	ADJ;INDF;NEUT;SG	vlijt|ig
vlinderen	V;SBJV;PRS;PL	vlinder|en
vlinder	V;IND;PRS;1;SG	vlinder
vloeibaar	ADJ;INDF;NEUT;SG	vloei|baar
vloeien	V;SBJV;PRS;PL	vloei|en
vloei	V;IND;PRS;1;SG	vloei
vloeren	V;SBJV;PRS;PL	vloer|en
vloer	V;IND;PRS;1;SG	vloer
vlotten	V;SBJV;PST;PL	vlott|en
vlot	V;IND;PRS;3;SG	vlot
vluchten	V;SBJV;PRS;PL	vlucht|en
vlucht	V;IND;PRS;3;SG	vlucht
vluchtig	ADJ;INDF;NEUT;SG	vlucht|ig
vlug	ADJ;INDF;NEUT;SG	vlug
vochtig	ADJ;INDF;NEUT;SG	vocht|ig
voeden	V;SBJV;PRS;PL	voed|en
voederen	V;SBJV;PRS;PL	voeder|en
voeder	V;IND;PRS;1;SG	voeder
voelen	V;SBJV;PRS;PL	voel|en
voetballen	V;SBJV;PRS;PL	voet|ball|en
voetbal	V;IND;PRS;1;SG	voet|bal
volbrengen	V;SBJV;PRS;PL	vol|breng|en
voleindigen	V;SBJV;PRS;PL	vol|eindig|en
volgen	V;SBJV;PRS;PL	volg|en
volgzaam	ADJ;INDF;NEUT;SG	volg|zaam
volharden	V;SBJV;PRS;PL	vol|hard|en
volks	ADJ;INDF;NEUT;SG	volk|s
volledig	ADJ;INDF;NEUT;SG	vol|ledig
volmondig	ADJ;INDF;NEUT;SG	vol|mond|ig
volslank	ADJ;INDF;NEUT;SG	vol|slank
volstaan	V;SBJV;PRS;PL	vol|staa|n
voltallig	ADJ;INDF;NEUT;SG	vol|tall|ig
voltooien	V;SBJV;PRS;PL	vol|tooi|en
voltrekken	V;SBJV;PRS;PL	vol|trekk|en
volwaardig	ADJ;INDF;NEUT;SG	vol|waard|ig
vonken	V;SBJV;PRS;PL	vonk|en
vonk	V;IND;PRS;1;SG	vonk
voorbeeldig	ADJ;INDF;NEUT;SG	voor|beeld|ig
voordelig	ADJ;INDF;NEUT;SG	voor|del|ig
voorhistorisch	ADJ;INDF;NEUT;SG	voor|historisch
voorlaatst	ADJ;INDF;NEUT;SG	voor|laatst
voormalig	ADJ;INDF;NEUT;SG	voor|mal|ig
voorspelbaar	ADJ;INDF;NEUT;SG	voor|spel|baar
voorspelden	V;SBJV;PST;PL	voor|speld|en
voorspellen	V;SBJV;PRS;PL	voor|spell|en
voorspel	V;IND;PRS;1;SG	voor|spel
voorspoedig	ADJ;INDF;NEUT;SG	voor|spoed|ig
voortijdig	ADJ;INDF;NEUT;SG	voor|tijd|ig
voortvluchtig	ADJ;INDF;NEUT;SG	voort|vlucht|ig
voorvaderlijk	ADJ;INDF;NEUT;SG	voor|vader|lijk
voorwaardelijk	ADJ;INDF;NEUT;SG	voorwaarde|lijk
voorwaarts	ADJ;INDF;NEUT;SG	voor|waarts
vorderen	V;SBJV;PRS;PL	vorder|en
vormeloos	ADJ;INDF;NEUT;SG	vorm|eloos
vormloos	ADJ;INDF;NEUT;SG	vorm|loos
voskleurig	ADJ;INDF;NEUT;SG	vos|kleur|ig
vossen	V;SBJV;PRS;PL	voss|en
vos	V;IND;PRS;1;SG	vos
votief	ADJ;INDF;NEUT;SG	vot|ief
vraatzuchtig	ADJ;INDF;NEUT;SG	vraat|zucht|ig
vreedzaam	ADJ;INDF;NEUT;SG	vreed|zaam
vreemd	ADJ;INDF;NEUT;SG	vreemd
vreemde	ADJ;INDF;PL	vreemd|e
vreesaanjagend	ADJ;INDF;NEUT;SG	vrees|aan|jag|end
vreesachtig	ADJ;INDF;NEUT;SG	vrees|achtig
vreselijk	ADJ;INDF;NEUT;SG	vres|elijk
vreugdeloos	ADJ;INDF;NEUT;SG	vreugde|loos
vrees	V;IND;PRS;1;SG	vrees
vrezen	V;SBJV;PRS;PL	vrezen
vreze	V;SBJV;PRS;SG	vreze
vriendelijk	ADJ;INDF;NEUT;SG	vriend|elijk
vriezen	V;SBJV;PRS;PL	vriezen
vrijgevig	ADJ;INDF;NEUT;SG	vrij|gev|ig
vrijgezel	ADJ;INDF;NEUT;SG	vrij|gezel
vrijwillig	ADJ;INDF;NEUT;SG	vrij|will|ig
vrijzinnig	ADJ;INDF;NEUT;SG	vrij|zinn|ig
vroed	ADJ;INDF;NEUT;SG	vroed
vroegtijdig	ADJ;INDF;NEUT;SG	vroeg|tijd|ig
vroeg	ADJ;INDF;NEUT;SG	vroeg
vrolijk	ADJ;INDF;NEUT;SG	vrolijk
vroom	ADJ;INDF;NEUT;SG	vroom
vrouwelijk	ADJ;INDF;NEUT;SG	vrouw|elijk
vruchtbaar	ADJ;INDF;NEUT;SG	vrucht|baar
vruchteloos	ADJ;INDF;NEUT;SG	vrucht|eloos
vuil	ADJ;INDF;NEUT;SG	vuil
vuist	V;IND;PRS;3;SG	vuist
vulkanisch	ADJ;INDF;NEUT;SG	vulkan|isch
vullen	V;SBJV;PRS;PL	vull|en
vurig	ADJ;INDF;NEUT;SG	vur|ig
vuurrood	ADJ;INDF;NEUT;SG	vuur|rood
vuurstenen	ADJ;INDF;PL	vuur|sten|en
vuurvast	ADJ;INDF;NEUT;SG	vuur|vast
waaier	V;IND;PRS;1;SG	waai|er
waakzaam	ADJ;INDF;NEUT;SG	waak|zaam
waanzinnig	ADJ;INDF;NEUT;SG	waan|zinn|ig
waarachtig	ADJ;INDF;NEUT;SG	waar|achtig
waarborgen	V;SBJV;PRS;PL	waar|borg|en
waarborg	V;IND;PRS;1;SG	waar|borg
waardeloos	ADJ;INDF;NEUT;SG	waarde|loos
waarderen	V;SBJV;PRS;PL	waard|er|en
waardevol	ADJ;INDF;NEUT;SG	waarde|vol
waardig	ADJ;INDF;NEUT;SG	waard|ig
waarneembaar	ADJ;INDF;NEUT;SG	waarneem|baar
wagenziek	ADJ;INDF;NEUT;SG	wagen|ziek
wakker	ADJ;INDF;NEUT;SG	wakker
walgelijk	ADJ;INDF;NEUT;SG	walg|elijk
walgen	V;SBJV;PRS;PL	walg|en
walg	V;IND;PRS;1;SG	walg
walmen	V;SBJV;PRS;PL	walm|en
walm	V;IND;PRS;1;SG	walm
walsen	V;SBJV;PRS;PL	wals|en
wals	V;IND;PRS;1;SG	wals
wandelen	V;SBJV;PRS;PL	wandel|en
wandel	V;IND;PRS;1;SG	wandel
waan	V;IND;PRS;1;SG	waan
wanen	V;SBJV;PRS;PL	wanen
wanhopig	ADJ;INDF;NEUT;SG	wan|hop|ig
wankelen	V;SBJV;PRS;PL	wankel|en
wankel	ADJ;INDF;NEUT;SG	wankel
wanordelijk	ADJ;INDF;NEUT;SG	wan|orde|lijk
wantrouwig	ADJ;INDF;NEUT;SG	wantrouw|ig
wapenen	V;SBJV;PRS;PL	wapenen
wapen	V;IND;PRS;1;SG	wapen
wapperen	V;SBJV;PRS;PL	wapper|en
wapper	V;IND;PRS;1;SG	wapper
warm	ADJ;INDF;NEUT;SG	warm
warmer	ADJ;INDF;PL;CMPR	warm|er
warrig	ADJ;INDF;NEUT;SG	warr|ig
wateren	V;SBJV;PRS;PL	water|en
water	V;IND;PRS;1;SG	water
waterig	ADJ;INDF;NEUT;SG	water|ig
waterpas	ADJ;INDF;NEUT;SG	water|pas
wazig	ADJ;INDF;NEUT;SG	waz|ig
wederrechtelijk	ADJ;INDF;NEUT;SG	weder|recht|elijk
wederzijds	ADJ;INDF;NEUT;SG	weder|zijd|s
wedijveren	V;SBJV;PRS;PL	wed|ijver|en
wedijver	V;IND;PRS;1;SG	wed|ijver
weeklagen	V;SBJV;PRS;PL	wee|klag|en
weergalmen	V;SBJV;PRS;PL	weer|galm|en
weergalm	V;IND;PRS;1;SG	weer|galm
weerkaatsen	V;SBJV;PRS;PL	weer|kaats|en
weerleggen	V;SBJV;PRS;PL	weer|legg|en
weerloos	ADJ;INDF;NEUT;SG	weer|loos
weerspiegelen	V;SBJV;PRS;PL	weer|spiegel|en
wee	ADJ;INDF;NEUT;SG	wee
weifelen	V;SBJV;PRS;PL	weifel|en
weigeren	V;SBJV;PRS;PL	weiger|en
wekelijks	ADJ;INDF;NEUT;SG	wek|elijks
wekelijk	ADJ;INDF;NEUT;SG	wek|elijk
welbemind	ADJ;INDF;NEUT;SG	wel|bemind
welgesteld	ADJ;INDF;NEUT;SG	wel|gesteld
welingelicht	ADJ;INDF;NEUT;SG	wel|ingelicht
welken	V;SBJV;PRS;PL	welk|en
welk	V;IND;PRS;1;SG	welk
wellen	V;SBJV;PRS;PL	well|en
wel	V;IND;PRS;1;SG	wel
wellevend	ADJ;INDF;NEUT;SG	wel|lev|end
weloverwogen	ADJ;INDF;PL	wel|overwogen
welriekend	ADJ;INDF;NEUT;SG	wel|riek|end
welven	V;SBJV;PRS;PL	welven
welwillend	ADJ;INDF;NEUT;SG	wel|will|end
wemelen	V;SBJV;PRS;PL	wemel|en
wendbaar	ADJ;INDF;NEUT;SG	wend|baar
wenen	V;SBJV;PRS;PL	wenen
wenken	V;SBJV;PRS;PL	wenk|en
wenk	V;IND;PRS;1;SG	wenk
wenden	V;SBJV;PST;PL	wend|en
wennen	V;SBJV;PRS;PL	wennen
wen	V;IND;PRS;1;SG	wen
wenselijk	ADJ;INDF;NEUT;SG	wens|elijk
wensen	V;SBJV;PRS;PL	wens|en
wens	V;IND;PRS;1;SG	wens
wentelen	V;SBJV;PRS;PL	wentel|en
wentel	V;IND;PRS;1;SG	wentel
wereldberoemd	ADJ;INDF;NEUT;SG	wereld|beroemd
wereldlijk	ADJ;INDF;NEUT;SG	wereld|lijk
wereldwijd	ADJ;INDF;NEUT;SG	wereld|wijd
werkeloos	ADJ;INDF;NEUT;SG	werk|eloos
werkloos	ADJ;INDF;NEUT;SG	werk|loos
werkschuw	ADJ;INDF;NEUT;SG	werk|schuw
werkzaam	ADJ;INDF;NEUT;SG	werk|zaam
werpen	V;SBJV;PRS;PL	werp|en
wervelen	V;SBJV;PRS;PL	wervel|en
wervel	V;IND;PRS;1;SG	wervel
westelijk	ADJ;INDF;NEUT;SG	west|elijk
westwaarts	ADJ;INDF;NEUT;SG	west|waarts
wetenschappelijk	ADJ;INDF;NEUT;SG	weten|schapp|elijk
wettelijk	ADJ;INDF;NEUT;SG	wett|elijk
wetteloos	ADJ;INDF;NEUT;SG	wett|eloos
wetten	V;SBJV;PST;PL	wett|en
wet	V;IND;PRS;3;SG	wet
wettig	ADJ;INDF;NEUT;SG	wett|ig
weven	V;SBJV;PRS;PL	weven
wezenlijk	ADJ;INDF;NEUT;SG	wezen|lijk
wiebelen	V;SBJV;PRS;PL	wiebel|en
wiegen	V;SBJV;PRS;PL	wieg|en
wieg	V;IND;PRS;1;SG	wieg
wijden	V;SBJV;PRS;PL	wijd|en
wijd	ADJ;INDF;NEUT;SG	wijd
wijsgerig	ADJ;INDF;NEUT;SG	wijsger|ig
wikkelen	V;SBJV;PRS;PL	wikkel|en
wikkel	V;IND;PRS;1;SG	wikkel
wild	ADJ;INDF;NEUT;SG	wild
willekeurig	ADJ;INDF;NEUT;SG	willekeur|ig
willen	V;SBJV;PRS;PL	will|en
wil	V;IND;PRS;3;SG	wil
windwaarts	ADJ;INDF;NEUT;SG	wind|waarts
winkelen	V;SBJV;PRS;PL	winkel|en
winkel	V;IND;PRS;1;SG	winkel
winnen	V;SBJV;PRS;PL	winnen
winstgevend	ADJ;INDF;NEUT;SG	win|st|gev|end
wintersport	V;IND;PRS;3;SG	winter|sport
wippen	V;SBJV;PRS;PL	wipp|en
wip	V;IND;PRS;1;SG	wip
wiskundig	ADJ;INDF;NEUT;SG	wiskund|ig
wisselen	V;SBJV;PRS;PL	wissel|en
wissel	V;IND;PRS;1;SG	wissel
wissen	V;SBJV;PRS;PL	wiss|en
wis	ADJ;INDF;NEUT;SG	wis
witheet	ADJ;INDF;NEUT;SG	wit|heet
witten	V;SBJV;PST;PL	witt|en
wit	V;IND;PRS;3;SG	wit
woeden	V;SBJV;PRS;PL	woed|en
woede	V;SBJV;PRS;SG	woede
woekeren	V;SBJV;PRS;PL	woeker|en
woeker	V;IND;PRS;1;SG	woeker
woelen	V;SBJV;PRS;PL	woel|en
woest	ADJ;INDF;NEUT;SG	woest
wollen	ADJ;INDF;PL	woll|en
wollig	ADJ;INDF;NEUT;SG	woll|ig
wonen	V;SBJV;PRS;PL	wonen
woon	V;IND;PRS;1;SG	woon
woonachtig	ADJ;INDF;NEUT;SG	woon|achtig
worgen	V;SBJV;PRS;PL	worg|en
worg	V;IND;PRS;1;SG	worg
wormstekig	ADJ;INDF;NEUT;SG	worm|stek|ig
worstelen	V;SBJV;PRS;PL	worstel|en
wortelen	V;SBJV;PRS;PL	wortel|en
wortel	V;IND;PRS;1;SG	wortel
worteltrekken	V;SBJV;PRS;PL	wortel|trekk|en
wraakzuchtig	ADJ;INDF;NEUT;SG	wraak|zucht|ig
wrang	ADJ;INDF;NEUT;SG	wrang
wreed	ADJ;INDF;NEUT;SG	wreed
wreken	V;SBJV;PRS;PL	wrek|en
wrevelig	ADJ;INDF;NEUT;SG	wrevel|ig
wreef	V;IND;PST;3;SG	wreef
wrijven	V;SBJV;PRS;PL	wrijven
wrikken	V;SBJV;PRS;PL	wrikk|en
wringen	V;SBJV;PRS;PL	wring|en
wrong	V;IND;PST;3;SG	wrong
wrochten	V;SBJV;PRS;PL	wrocht|en
wroegen	V;SBJV;PRS;PL	wroeg|en
gewroet	V.PTCP;PST	ge|wroet
wroeten	V;SBJV;PRS;PL	wroet|en
wurgen	V;SBJV;PRS;PL	wurg|en
wurmen	V;SBJV;PRS;PL	wurm|en
wurm	V;IND;PRS;1;SG	wurm
zachtaardig	ADJ;INDF;NEUT;SG	zacht|aard|ig
zachtmoedig	ADJ;INDF;NEUT;SG	zacht|moed|ig
zacht	ADJ;INDF;NEUT;SG	zacht
zachtzinnig	ADJ;INDF;NEUT;SG	zacht|zinn|ig
zaag	V;IND;PRS;1;SG	zaag
zagen	V;SBJV;PST;PL	zag|en
zakelijk	ADJ;INDF;NEUT;SG	zak|elijk
zalmkleurig	ADJ;INDF;NEUT;SG	zalm|kleur|ig
zat	ADJ;INDF;NEUT;SG	zat
zedelijk	ADJ;INDF;NEUT;SG	zede|lijk
zedig	ADJ;INDF;NEUT;SG	zed|ig
zeepachtig	ADJ;INDF;NEUT;SG	zeep|achtig
zeer	ADJ;INDF;NEUT;SG	zeer
zeeziek	ADJ;INDF;NEUT;SG	zee|ziek
zegenen	V;SBJV;PRS;PL	zegenen
zegen	V;IND;PRS;1;SG	zegen
zegevieren	V;SBJV;PRS;PL	zege|vier|en
zeiknat	ADJ;INDF;NEUT;SG	zeik|nat
zeilen	V;SBJV;PRS;PL	zeil|en
zeil	V;IND;PRS;1;SG	zeil
zeker	ADJ;INDF;NEUT;SG	zeker
zelfingenomen	ADJ;INDF;PL	zelf|ingenomen
zelfrijzend	ADJ;INDF;NEUT;SG	zelf|rijzend
zelfverzekerd	ADJ;INDF;NEUT;SG	zelf|verzekerd
zelfzeker	ADJ;INDF;NEUT;SG	zelf|zeker
zenden	V;SBJV;PRS;PL	zend|en
zonde	V;SBJV;PST;SG	zonde
zengen	V;SBJV;PRS;PL	zeng|en
zeng	V;IND;PRS;1;SG	zeng
zenuwachtig	ADJ;INDF;NEUT;SG	zenuw|achtig
zenuwslopend	ADJ;INDF;NEUT;SG	zenuw|slop|end
zeuren	V;SBJV;PRS;PL	zeur|en
zeur	V;IND;PRS;1;SG	zeur
ziekelijk	ADJ;INDF;NEUT;SG	ziek|elijk
ziek	ADJ;INDF;NEUT;SG	ziek
zien	V;SBJV;PRS;PL	zie|n
ziften	V;SBJV;PRS;PL	zift|en
zift	V;IND;PRS;3;SG	zift
zilveren	ADJ;INDF;PL	zilver|en
zilverkleurig	ADJ;INDF;NEUT;SG	zilver|kleur|ig
zingen	V;SBJV;PRS;PL	zing|en
zinloos	ADJ;INDF;NEUT;SG	zin|loos
zinnelijk	ADJ;INDF;NEUT;SG	zinn|elijk
zinnenprikkelend	ADJ;INDF;NEUT;SG	zinn|en|prikkelend
zinnig	ADJ;INDF;NEUT;SG	zinn|ig
zinvol	ADJ;INDF;NEUT;SG	zin|vol
zoeken	V;SBJV;PRS;PL	zoek|en
zoek	V;IND;PRS;1;SG	zoek
zoemen	V;SBJV;PRS;PL	zoem|en
zoenen	V;SBJV;PRS;PL	zoenen
zoen	V;IND;PRS;1;SG	zoen
zoeten	V;SBJV;PRS;PL	zoet|en
zoet	V;IND;PRS;3;SG	zoet
zoetzuur	ADJ;INDF;NEUT;SG	zoet|zuur
zogeheten	ADJ;INDF;PL	zo|geheten
zogenaamd	ADJ;INDF;NEUT;SG	zo|genaamd
zogenoemd	ADJ;INDF;NEUT;SG	zo|genoemd
zogen	V;SBJV;PST;PL	zog|en
zolen	V;SBJV;PRS;PL	zol|en
zool	V;IND;PRS;1;SG	zool
zomen	V;SBJV;PRS;PL	zom|en
zoom	V;IND;PRS;1;SG	zoom
zomeren	V;SBJV;PRS;PL	zomer|en
zomer	V;IND;PRS;1;SG	zomer
zonderlinge	ADJ;INDF;PL	zonderling|e
zondig	ADJ;INDF;NEUT;SG	zond|ig
zonnebaden	V;SBJV;PRS;PL	zonn|e|bad|en
zonnig	ADJ;INDF;NEUT;SG	zonn|ig
zoomen	V;SBJV;PRS;PL	zoom|en
zoor	ADJ;INDF;NEUT;SG	zoor
zorgeloos	ADJ;INDF;NEUT;SG	zorg|eloos
zorgen	V;SBJV;PRS;PL	zorg|en
zorg	V;IND;PRS;1;SG	zorg
zorgwekkend	ADJ;INDF;NEUT;SG	zorg|wekk|end
zorgzaam	ADJ;INDF;NEUT;SG	zorg|zaam
zot	ADJ;INDF;NEUT;SG	zot
zouten	V;SBJV;PRS;PL	zout|en
zoutte	V;SBJV;PST;SG	zout|te
zout	ADJ;INDF;NEUT;SG	zout
zouter	ADJ;INDF;PL;CMPR	zout|er
zoveelste	ADJ;INDF;PL	zo|veel|ste
gezucht	V.PTCP;PST	ge|zucht
zuchten	V;SBJV;PRS;PL	zucht|en
zucht	V;IND;PRS;3;SG	zucht
zuidelijk	ADJ;INDF;NEUT;SG	zuid|elijk
zuidoostelijk	ADJ;INDF;NEUT;SG	zuid|oost|elijk
zuidwaarts	ADJ;INDF;NEUT;SG	zuid|waarts
zuidwestelijk	ADJ;INDF;NEUT;SG	zuid|west|elijk
zuigen	V;SBJV;PRS;PL	zuig|en
zuipen	V;SBJV;PRS;PL	zuip|en
zuip	V;IND;PRS;1;SG	zuip
zuiveren	V;SBJV;PRS;PL	zuiver|en
zuiver	ADJ;INDF;NEUT;SG	zuiver
zullen	V;SBJV;PRS;PL	zull|en
zult	V;IND;PRS;2;SG	zult
zwaaien	V;SBJV;PRS;PL	zwaai|en
zwaai	V;IND;PRS;1;SG	zwaai
zwaargewond	ADJ;INDF;NEUT;SG	zwaar|gewond
zwaarmoedig	ADJ;INDF;NEUT;SG	zwaar|moed|ig
zwaarwegend	ADJ;INDF;NEUT;SG	zwaar|weg|end
zwaar	ADJ;INDF;NEUT;SG	zwaar
zwabberen	V;SBJV;PRS;PL	zwabber|en
zwabber	V;IND;PRS;1;SG	zwabber
zwak	ADJ;INDF;NEUT;SG	zwak
zwanger	ADJ;INDF;NEUT;SG	zwanger
zweefvliegen	V;SBJV;PRS;PL	zweef|vlieg|en
zwellen	V;SBJV;PRS;PL	zwell|en
zwemmen	V;SBJV;PRS;PL	zwemm|en
zwendelen	V;SBJV;PRS;PL	zwendel|en
zwendel	V;IND;PRS;1;SG	zwendel
zweep	V;IND;PRS;1;SG	zweep
zwepen	V;SBJV;PRS;PL	zwep|en
zwerven	V;SBJV;PRS;PL	zwerven
zweet	V;IND;PRS;3;SG	zweet
zweten	V;SBJV;PRS;PL	zwet|en
zwetsen	V;SBJV;PRS;PL	zwets|en
zwichten	V;SBJV;PRS;PL	zwicht|en
zwiepen	V;SBJV;PRS;PL	zwiep|en
zwiep	V;IND;PRS;1;SG	zwiep
zwijgen	V;SBJV;PRS;PL	zwijg|en
zwijgzaam	ADJ;INDF;NEUT;SG	zwijg|zaam
zwoegen	V;SBJV;PRS;PL	zwoeg|en
zwoel	ADJ;INDF;NEUT;SG	zwoel
